DDDDDDDDDDDDDDDDDDDDDDDDDDDDDDDDDDDDDDDD
DDDDDDDDDDDDDDDDDDDDDDDDDDDDDDDDDDDDDDDD
DDDDDDDDDDDDDDDDDDDDDDDDDDDDDDDDDDDDDDDD
DDDDDDDDDDDDDDDDDDDDDDDDDDDDDDDDDDDDDDDD
DDDDDDDDDDDDDDDDDDDDDDDDDDDDDDDDDDDDDDDD
DDDDDDDDDDDDDDDDDDDDDDDDDDDDDDDDDDDDDDDD
DDDDDDDDDDDDDDDDDDDDDDDDDDDDDDDDDDDDDDDD
DDDDDDDDDDDDDDDDDDDDDDDDDDDDDDDDDDDDDDDD
DDDDDDDDDDDDDDDDDDDDDDDDDDDDDDDDDDDDDDDD
DDDDDDDDDDDDDDDDDDDDDDDDDDDDDDDDDDDDDDDD
DDDDDDDDDDDDDDDDDDDDDDDDDDDDDDDDDDDDDDDD
DDDDDDDDDDDDDDDDDDDDDDDDDDDDDDDDDDDDDDDD
DDDDDDDDDDDDDDDDDDDDDDDDDDDDDDDDDDDDDDDD
DDDDDDDDDDDDDDDDDDDDDDDDDDDDDDDDDDDDDDDD
DDDDDDDDDDDDDDDDDDDDDDDDDDDDDDDDDDDDDDDD
DDDDDDDDDDDDDDDDDDDDDDDDDDDDDDDDDDDDDDDD
DDDDDDDDDDDDDDDDDDDDDDDDDDDDDDDDDDDDDDDD
DDDDDDDDDDDDDDDDDDDDDDDDDDDDDDDDDDDDDDDD
DDDDDDDDDDDDDDDDDDDDDDDDDDDDDDDDDDDDDDDD
DDDDDDDDDDDDDDDDDDDDDDDDDDDDDDDDDDDDDDDD
---
......................WWWWWWWWWWWWWWWWWW
....................WWWWWWWWWWWWWWWWWWWW
....................WWWWWWWWWWWWWWWWWWWW
...................WWWWWWWWWWWWWWWWWWWWW
.................WWWWWWWWWWWWWWWWWWWWWWW
................WWWWWWWWWWWWWWWWWWWWWWWW
.................WWWWWWWWWWWWWWWWWWWWWWW
................WWWWWWWWWWWWWWWWWWWWWWWW
................WWWWWWWWWWWWWWWWWWWWWWWW
.................WWWWWWWWWWWWWWWWWWWWWWW
...................WWWWWWWWWWWWWWWWWWWWW
.................WWWWWWWWWWWWWWWWWWWWWWW
..................WWWWWWWWWWWWWWWWWWWWWW
...................WWWWWWWWWWWWWWWWWWWWW
..................WWWWWWWWWWWWWWWWWWWWWW
.................WWWWWWWWWWWWWWWWWWWWWWW
...............WWWWWWWWWWWWWWWWWWWWWWWWW
..............WWWWWWWWWWWWWWWWWWWWWWWWWW
................WWWWWWWWWWWWWWWWWWWWWWWW
..................WWWWWWWWWWWWWWWWWWWWWW