DDDDDDDDDDDDDDDDDDDDDDDDDDDDDDDDDDDDDDDDDDDDDDDDDDDDDDDDDDDDDDDDDDDDDD
DDDDDDDDDDDDDDDDDDDDDDDDDDDDDDDDDDDDDDDDDDDDDDDDDDDDDDDDDDDDDDDDDDDDDD
DDDDDDDDDDDDDDDDDDDDDDDDDDDDDDDDDDDDDDDDDDDDDDDDDDDDDDDDDDDDDDDDDDDDDD
DDDDDDDDDDDDDDDDDDDDDDDDDDDDDDDDDDDDDDDDDDDDDDDDDDDDDDDDDDDDDDDDDDDDDD
DDDDDDDDDDDDDDDDDDDDDDDDDDDDDDDDDDDDDDDDDDDDDDDDDDDDDDDDDDDDDDDDDDDDDD
DDDDDDDDDDDDDDDDDDDDDDDDDDDDDDDDDDDDDDDDDDDDDDDDDDDDDDDDDDDDDDDDDDDDDD
DDDDDDDDDDDDDDDDDDDDDDDDDDDDDDDDDDDDDDDDDDDDDDDDDDDDDDDDDDDDDDDDDDDDDD
DDDDDDDDDDDDDDDDDDDDDDDDDDDDDDDDDDDDDDDDDDDDDDDDDDDDDDDDDDDDDDDDDDDDDD
DDDDDDDDDDDDDDDDDDDDDDDDDDDDDDDDDDDDDDDDDDDDDDDDDDDDDDDDDDDDDDDDDDDDDD
DDDDDDDDDDDDDDDDDDDDDDDDDDDDDDDDDDDDDDDDDDDDDDDDDDDDDDDDDDDDDDDDDDDDDD
DDDDDDDDDDDDDDDDDDDDDDDDDDDDDDDDDDDDDDDDDDDDDDDDDDDDDDDDDDDDDDDDDDDDDD
DDDDDDDDDDDDDDDDDDDDDDDDDDDDDDDDDDDDDDDDDDDDDDDDDDDDDDDDDDDDDDDDDDDDDD
DDDDDDDDDDDDDDDDDDDDDDDDDDDDDDDDDDDDDDDDDDDDDDDDDDDDDDDDDDDDDDDDDDDDDD
DDDDDDDDDDDDDDDDDDDDDDDDDDDDDDDDDDDDDDDDDDDDDDDDDDDDDDDDDDDDDDDDDDDDDD
DDDDDDDDDDDDDDDDDDDDDDDDDDDDDDDDDDDDDDDDDDDDDDDDDDDDDDDDDDDDDDDDDDDDDD
DDDDDDDDDDDDDDDDDDDDDDDDDDDDDDDDDDDDDDDDDDDDDDDDDDDDDDDDDDDDDDDDDDDDDD
DDDDDDDDDDDDDDDDDDDDDDDDDDDDDDDDDDDDDDDDDDDDDDDDDDDDDDDDDDDDDDDDDDDDDD
DDDDDDDDDDDDDDDDDDDDDDDDDDDDDDDDDDDDDDDDDDDDDDDDDDDDDDDDDDDDDDDDDDDDDD
DDDDDDDDDDDDDDDDDDDDDDDDDDDDDDDDDDDDDDDDDDDDDDDDDDDDDDDDDDDDDDDDDDDDDD
DDDDDDDDDDDDDDDDDDDDDDDDDDDDDDDDDDDDDDDDDDDDDDDDDDDDDDDDDDDDDDDDDDDDDD
DDDDDDDDDDDDDDDDDDDDDDDDDDDDDDDDDDDDDDDDDDDDDDDDDDDDDDDDDDDDDDDDDDDDDD
DDDDDDDDDDDDDDDDDDDDDDDDDDDDDDDDDDDDDDDDDDDDDDDDDDDDDDDDDDDDDDDDDDDDDD
DDDDDDDDDDDDDDDDDDDDDDDDDDDDDDDDDDDDDDDDDDDDDDDDDDDDDDDDDDDDDDDDDDDDDD
DDDDDDDDDDDDDDDDDDDDDDDDDDDDDDDDDDDDDDDDDDDDDDDDDDDDDDDDDDDDDDDDDDDDDD
DDDDDDDDDDDDDDDDDDDDDDDDDDDDDDDDDDDDDDDDDDDDDDDDDDDDDDDDDDDDDDDDDDDDDD
DDDDDDDDDDDDDDDDDDDDDDDDDDDDDDDDDDDDDDDDDDDDDDDDDDDDDDDDDDDDDDDDDDDDDD
DDDDDDDDDDDDDDDDDDDDDDDDDDDDDDDDDDDDDDDDDDDDDDDDDDDDDDDDDDDDDDDDDDDDDD
DDDDDDDDDDDDDDDDDDDDDDDDDDDDDDDDDDDDDDDDDDDDDDDDDDDDDDDDDDDDDDDDDDDDDD
DDDDDDDDDDDDDDDDDDDDDDDDDDDDDDDDDDDDDDDDDDDDDDDDDDDDDDDDDDDDDDDDDDDDDD
DDDDDDDDDDDDDDDDDDDDDDDDDDDDDDDDDDDDDDDDDDDDDDDDDDDDDDDDDDDDDDDDDDDDDD
DDDDDDDDDDDDDDDDDDDDDDDDDDDDDDDDDDDDDDDDDDDDDDDDDDDDDDDDDDDDDDDDDDDDDD
DDDDDDDDDDDDDDDDDDDDDDDDDDDDDDDDDDDDDDDDDDDDDDDDDDDDDDDDDDDDDDDDDDDDDD
DDDDDDDDDDDDDDDDDDDDDDDDDDDDDDDDDDDDDDDDDDDDDDDDDDDDDDDDDDDDDDDDDDDDDD
DDDDDDDDDDDDDDDDDDDDDDDDDDDDDDDDDDDDDDDDDDDDDDDDDDDDDDDDDDDDDDDDDDDDDD
DDDDDDDDDDDDDDDDDDDDDDDDDDDDDDDDDDDDDDDDDDDDDDDDDDDDDDDDDDDDDDDDDDDDDD
DDDDDDDDDDDDDDDDDDDDDDDDDDDDDDDDDDDDDDDDDDDDDDDDDDDDDDDDDDDDDDDDDDDDDD
DDDDDDDDDDDDDDDDDDDDDDDDDDDDDDDDDDDDDDDDDDDDDDDDDDDDDDDDDDDDDDDDDDDDDD
DDDDDDDDDDDDDDDDDDDDDDDDDDDDDDDDDDDDDDDDDDDDDDDDDDDDDDDDDDDDDDDDDDDDDD
DDDDDDDDDDDDDDDDDDDDDDDDDDDDDDDDDDDDDDDDDDDDDDDDDDDDDDDDDDDDDDDDDDDDDD
DDDDDDDDDDDDDDDDDDDDDDDDDDDDDDDDDDDDDDDDDDDDDDDDDDDDDDDDDDDDDDDDDDDDDD
DDDDDDDDDDDDDDDDDDDDDDDDDDDDDDDDDDDDDDDDDDDDDDDDDDDDDDDDDDDDDDDDDDDDDD
DDDDDDDDDDDDDDDDDDDDDDDDDDDDDDDDDDDDDDDDDDDDDDDDDDDDDDDDDDDDDDDDDDDDDD
DDDDDDDDDDDDDDDDDDDDDDDDDDDDDDDDDDDDDDDDDDDDDDDDDDDDDDDDDDDDDDDDDDDDDD
DDDDDDDDDDDDDDDDDDDDDDDDDDDDDDDDDDDDDDDDDDDDDDDDDDDDDDDDDDDDDDDDDDDDDD
DDDDDDDDDDDDDDDDDDDDDDDDDDDDDDDDDDDDDDDDDDDDDDDDDDDDDDDDDDDDDDDDDDDDDD
DDDDDDDDDDDDDDDDDDDDDDDDDDDDDDDDDDDDDDDDDDDDDDDDDDDDDDDDDDDDDDDDDDDDDD
DDDDDDDDDDDDDDDDDDDDDDDDDDDDDDDDDDDDDDDDDDDDDDDDDDDDDDDDDDDDDDDDDDDDDD
DDDDDDDDDDDDDDDDDDDDDDDDDDDDDDDDDDDDDDDDDDDDDDDDDDDDDDDDDDDDDDDDDDDDDD
DDDDDDDDDDDDDDDDDDDDDWDWDDDDDDDDDDDDDDDDDDDDDDDDDDDDDDDDDDDDDDDDDDDDDD
DDDDDDDDDDDDDDDDDDDDDDDDDDDDDDDDDDDDDDDDDDDDDDDDDDDDDDDDDDDDDDDDDDDDDD
DDDDDDDDDDDWWWDWDDDDSDDDDDDDDDDDDDDDDDDDDDDDDDDDDDDDDDDDDDDDDDDDDDDDDD
DDDDDDDDDDDDDDDDDDDDDDDDDDDDDDDDDDDDDDDDDDDDDDDDDDDDDDDDDDDDDDDDDDDDDD
DDDDDDDDDDDDWDDDDDDDSDDDDDDDDDDDDDDDDDDDDDDDDDDDDDDDDDDDDDDDDDDDDDDDDD
DDDDDDDDDDDDDDDDDDDDDDDDDDDDDDDDDDDDDDDDDDDDDDDDDDDDDDDDDDDDDDDDDDDDDD
DDDDDDDDDDDDWDDDDDDDSDDDDDDDDDDDDDDDDDDDDDDDDDDDDDDDDDDDDDDDDDDDDDDDDD
DDDDDDDDDDDDDDDDDDDDDDDDDDDDDDDDDDDDDDDDDDDDDDDDDDDDDDDDDDDDDDDDDDDDDD
DDDDDDDDDDDDDDDDDDDDDDDDDDDDSDDDDDDDDDDDDDDDDDDDDDDDDDDDDDDDDDDDDDDDDD
DDDDDDDDDDDDDDDDDDDDDDDDDDDDDDDDDDDDDDDDDDDDDDDDDDDDDDDDDDDDDDDDDDDDDD
DDDDDDDDDDDDDDDDDDDDDDDDDDDDSDDDDDDDDDDDDDDDDDDDDDDDDDDDDDDDDDDDDDDDDD
DDDDDDDDDDDDDDDDDDDDDDDDDDDDDDDDDDDDDDDDDDDDDDDDDDDDDDDDDDDDDDDDDDDDDD
DDDDDDDDDDDDDDDDDDDDDDDDDDDDDDDDDDDDDDDDDDDDDDDDDDDDDDDDDDDDDDDDDDDDDD
DDDDDDDDDDDDDDDDDDDDDDDDDDDDDDDDDDDDDDDDDDDDDDDDDDDDDDDDDDDDDDDDDDDDDD
DDDDDDDDDDDDDDDDDDDDDDDDDDDDDDDDDDDDDDDDDDDDDDDDDDDDDDDDDDDDDDDDDDDDDD
DDDDDDDDDDDDDDDDDDDDDDDDDDDDDDDDDDDDDDDDDDDDDDDDDDDDDDDDDDDDDDDDDDDDDD
DDDDDDDDDDDDDDDDDDDDDDDDDDDDDDDDDDDDDDDDDDDDDDDDDDDDDDDDDDDDDDDDDDDDDD
DDDDDDDDDDDDDDDDDDDDDDDDDDDDDDDDDDDDDDDDDDDDDDDDDDDDDDDDDDDDDDDDDDDDDD
DDDDDDDDDDDDDDDDDDDDDDDDDDDDDDDDDDDDDDDDDDDDDDDDDDDDDDDDDDDDDDDDDDDDDD
DDDDDDDDDDDDDDDDDDDDDDDDDDDDDDDDDDDDDDDDDDDDDDDDDDDDDDDDDDDDDDDDDDDDDD
DDDDDDDDDDDDDDDDDDDDDDDDDDDDDDDDDDDDDDDDDDDDDDDDDDDDDDDDDDDDDDDDDDDDDD
DDDDDDDDDDDDDDDDDDDDDDDDDDDDDDDDDDDDDDDDDDDDDDDDDDDDDDDDDDDDDDDDDDDDDD
---
............................WWWWWWWWWWWWWWWWWWWWWWWWWWWWWWWWWWWWWWWWWW
...........................WWWWWWWWWWWWWWWWWWWWWWWWWWWWWWWWWWWWWWWWWWW
...........................WWWWWWWWWWWWWWWWWWWWWWWWWWWWWWWWWWWWWWWWWWW
.............................WWWWWWWWWWWWWWWWWWWWWWWWWWWWWWWWWWWWWWWWW
............................WWWWWWWWWWWWWWWWWWWWWWWWWWWWWWWWWWWWWWWWWW
...........................WWWWWWWWWWWWWWWWWWWWWWWWWWWWWWWWWWWWWWWWWWW
............................WWWWWWWWWWWWWWWWWWWWWWWWWWWWWWWWWWWWWWWWWW
...........................WWWWWWWWWWWWWWWWWWWWWWWWWWWWWWWWWWWWWWWWWWW
.........................WWWWWWWWWWWWWWWWWWWWWWWWWWWWWWWWWWWWWWWWWWWWW
..........................WWWWWWWWWWWWWWWWWWWWWWWWWWWWWWWWWWWWWWWWWWWW
...........................WWWWWWWWWWWWWWWWWWWWWWWWWWWWWWWWWWWWWWWWWWW
..........................WWWWWWWWWWWWWWWWWWWWWWWWWWWWWWWWWWWWWWWWWWWW
..........................WWWWWWWWWWWWWWWWWWWWWWWWWWWWWWWWWWWWWWWWWWWW
............................WWWWWWWWWWWWWWWWWWWWWWWWWWWWWWWWWWWWWWWWWW
..........................WWWWWWWWWWWWWWWWWWWWWWWWWWWWWWWWWWWWWWWWWWWW
...........................WWWWWWWWWWWWWWWWWWWWWWWWWWWWWWWWWWWWWWWWWWW
...........................WWWWWWWWWWWWWWWWWWWWWWWWWWWWWWWWWWWWWWWWWWW
.........................WWWWWWWWWWWWWWWWWWWWWWWWWWWWWWWWWWWWWWWWWWWWW
.........................WWWWWWWWWWWWWWWWWWWWWWWWWWWWWWWWWWWWWWWWWWWWW
...........................WWWWWWWWWWWWWWWWWWWWWWWWWWWWWWWWWWWWWWWWWWW
.............................WWWWWWWWWWWWWWWWWWWWWWWWWWWWWWWWWWWWWWWWW
............................WWWWWWWWWWWWWWWWWWWWWWWWWWWWWWWWWWWWWWWWWW
..............................WWWWWWWWWWWWWWWWWWWWWWWWWWWWWWWWWWWWWWWW
............................WWWWWWWWWWWWWWWWWWWWWWWWWWWWWWWWWWWWWWWWWW
..........................WWWWWWWWWWWWWWWWWWWWWWWWWWWWWWWWWWWWWWWWWWWW
...........................WWWWWWWWWWWWWWWWWWWWWWWWWWWWWWWWWWWWWWWWWWW
............................WWWWWWWWWWWWWWWWWWWWWWWWWWWWWWWWWWWWWWWWWW
.............................WWWWWWWWWWWWWWWWWWWWWWWWWWWWWWWWWWWWWWWWW
...............................WWWWWWWWWWWWWWWWWWWWWWWWWWWWWWWWWWWWWWW
................................WWWWWWWWWWWWWWWWWWWWWWWWWWWWWWWWWWWWWW
..................................WWWWWWWWWWWWWWWWWWWWWWWWWWWWWWWWWWWW
....................................WWWWWWWWWWWWWWWWWWWWWWWWWWWWWWWWWW
...................................WWWWWWWWWWWWWWWWWWWWWWWWWWWWWWWWWWW
....................................WWWWWWWWWWWWWWWWWWWWWWWWWWWWWWWWWW
...................................WWWWWWWWWWWWWWWWWWWWWWWWWWWWWWWWWWW
....................................WWWWWWWWWWWWWWWWWWWWWWWWWWWWWWWWWW
..................................WWWWWWWWWWWWWWWWWWWWWWWWWWWWWWWWWWWW
................................WWWWWWWWWWWWWWWWWWWWWWWWWWWWWWWWWWWWWW
..............................WWWWWWWWWWWWWWWWWWWWWWWWWWWWWWWWWWWWWWWW
............................WWWWWWWWWWWWWWWWWWWWWWWWWWWWWWWWWWWWWWWWWW
..........................WWWWWWWWWWWWWWWWWWWWWWWWWWWWWWWWWWWWWWWWWWWW
...........................WWWWWWWWWWWWWWWWWWWWWWWWWWWWWWWWWWWWWWWWWWW
.............................WWWWWWWWWWWWWWWWWWWWWWWWWWWWWWWWWWWWWWWWW
..............................WWWWWWWWWWWWWWWWWWWWWWWWWWWWWWWWWWWWWWWW
................................WWWWWWWWWWWWWWWWWWWWWWWWWWWWWWWWWWWWWW
.................................WWWWWWWWWWWWWWWWWWWWWWWWWWWWWWWWWWWWW
.................................WWWWWWWWWWWWWWWWWWWWWWWWWWWWWWWWWWWWW
.................................WWWWWWWWWWWWWWWWWWWWWWWWWWWWWWWWWWWWW
...................................WWWWWWWWWWWWWWWWWWWWWWWWWWWWWWWWWWW
....................................WWWWWWWWWWWWWWWWWWWWWWWWWWWWWWWWWW
.....................................WWWWWWWWWWWWWWWWWWWWWWWWWWWWWWWWW
....................................WWWWWWWWWWWWWWWWWWWWWWWWWWWWWWWWWW
....................................WWWWWWWWWWWWWWWWWWWWWWWWWWWWWWWWWW
..................................WWWWWWWWWWWWWWWWWWWWWWWWWWWWWWWWWWWW
....................................WWWWWWWWWWWWWWWWWWWWWWWWWWWWWWWWWW
..................................WWWWWWWWWWWWWWWWWWWWWWWWWWWWWWWWWWWW
................................WWWWWWWWWWWWWWWWWWWWWWWWWWWWWWWWWWWWWW
...............................WWWWWWWWWWWWWWWWWWWWWWWWWWWWWWWWWWWWWWW
.................................WWWWWWWWWWWWWWWWWWWWWWWWWWWWWWWWWWWWW
...................................WWWWWWWWWWWWWWWWWWWWWWWWWWWWWWWWWWW
....................................WWWWWWWWWWWWWWWWWWWWWWWWWWWWWWWWWW
.....................................WWWWWWWWWWWWWWWWWWWWWWWWWWWWWWWWW
...................................WWWWWWWWWWWWWWWWWWWWWWWWWWWWWWWWWWW
....................................WWWWWWWWWWWWWWWWWWWWWWWWWWWWWWWWWW
.....................................WWWWWWWWWWWWWWWWWWWWWWWWWWWWWWWWW
......................................WWWWWWWWWWWWWWWWWWWWWWWWWWWWWWWW
......................................WWWWWWWWWWWWWWWWWWWWWWWWWWWWWWWW
........................................WWWWWWWWWWWWWWWWWWWWWWWWWWWWWW
.........................................WWWWWWWWWWWWWWWWWWWWWWWWWWWWW
.........................................WWWWWWWWWWWWWWWWWWWWWWWWWWWWW