DDDDDDDDDD
DDDDDDDDDD
DDDDDDDDDD
DDDDDDDDDD
DDDDDDDDDD
DDDDDDDDDD
DDDDDDDDDD
DDDDDDDDDD
DDDDDDDDDD
DDDDDDDDDD
---
WWWWWW.WWW
WWWW...WWW
WWWWWW.WWW
WWWWWWW.WW
WWWWW...WW
WWW...WWWW
WW....WWWW
WWWW.WWWWW
WWW.WWWWWW
WW.WWWWWWW