DDDDDDDDDDDDDDDDDDDDDDDDDDDDDDDDDDDDDDDDDDDDDDDDDD
DDDDDDDDDDDDDDDDDDDDDDDDDDDDDDDDDDDDDDDDDDDDDDDDDD
DDDDDDDDDDDDDDDDDDDDDDDDDDDDDDDDDDDDDDDDDDDDDDDDDD
DDDDDDDDDDDDDDDDDDDDDDDDDDDDDDDDDDDDDDDDDDDDDDDDDD
DDDDDDDDDDDDDDDDDDDDDDDDDDDDDDDDDDDDDDDDDDDDDDDDDD
DDDDDDDDDDDDDDDDDDDDDDDDDDDDDDDDDDDDDDDDDDDDDDDDDD
DDDDDDDDDDDDDDDDDDDDDDDDDDDDDDDDDDDDDDDDDDDDDDDDDD
DDDDDDDDDDDDDDDDDDDDDDDDDDDDDDDDDDDDDDDDDDDDDDDDDD
DDDDDDDDDDDDDDDDDDDDDDDDDDDDDDDDDDDDDDDDDDDDDDDDDD
DDDDDDDDDDDDDDDDDDDDDDDDDDDDDDDDDDDDDDDDDDDDDDDDDD
DDDDDDDDDDDDDDDDDDDDDDDDDDDDDDDDDDDDDDDDDDDDDDDDDD
DDDDDDDDDDDDDDDDDDDDDDDDDDDDDDDDDDDDDDDDDDDDDDDDDD
DDDDDDDDDDDDDDDDDDDDDDDDDDDDDDDDDDDDDDDDDDDDDDDDDD
DDDDDDDDDDDDDDDDDDDDDDDDDDDDDDDDDDDDDDDDDDDDDDDDDD
DDDDDDDDDDDDDDDDDDDDDDDDDDDDDDDDDDDDDDDDDDDDDDDDDD
DDDDDDDDDDDDDDDDDDDDDDDDDDDDDDDDDDDDDDDDDDDDDDDDDD
DDDDDDDDDDDDDDDDDDDDDDDDDDDDDDDDDDDDDDDDDDDDDDDDDD
DDDDDDDDDDDDDDDDDDDDDDDDDDDDDDDDDDDDDDDDDDDDDDDDDD
DDDDDDDDDDDDDDDDDDDDDDDDDDDDDDDDDDDDDDDDDDDDDDDDDD
DDDDDDDDDDDDDDDDDDDDDDDDDDDDDDDDDDDDDDDDDDDDDDDDDD
DDDDDDDDDDDDDDDDDDDDDDDDDDDDDDDDDDDDDDDDDDDDDDDDDD
DDDDDDDDDDDDDDDDDDDDDDDDDDDDDDDDDDDDDDDDDDDDDDDDDD
DDDDDDDDDDDDDDDDDDDDDDDDDDDDDDDDDDDDDDDDDDDDDDDDDD
DDDDDDDDDDDDDDDDDDDDDDDDDDDDDDDDDDDDDDDDDDDDDDDDDD
DDDDDDDDDDDDDDDDDDDDDDDDDDDDDDDDDDDDDDDDDDDDDDDDDD
DDDDDDDDDDDDDDDDDDDDDDDDDDDDDDDDDDDDDDDDDDDDDDDDDD
DDDDDDDDDDDDDDDDDDDDDDDDDDDDDDDDDDDDDDDDDDDDDDDDDD
DDDDDDDDDDDDDDDDDDDDDDDDDDDDDDDDDDDDDDDDDDDDDDDDDD
DDDDDDDDDDDDDDDDDDDDDDDDDDDDDDDDDDDDDDDDDDDDDDDDDD
DDDDDDDDDDDDDDDDDDDDDDDDDDDDDDDDDDDDDDDDDDDDDDDDDD
DDDDDDDDDDDDDDDDDDDDDDDDDDDDDDDDDDDDDDDDDDDDDDDDDD
DDDDDDDDDDDDDDDDDDDDDDDDDDDDDDDDDDDDDDDDDDDDDDDDDD
DDDDDDDDDDDDDDDDDDDDDDDDDDDDDDDDDDDDDDDDDDDDDDDDDD
DDDDDDDDDDDDDDDDDDDDDDDDDDDDDDDDDDDDDDDDDDDDDDDDDD
DDDDDDDDDDDDDDDDDDDDDDDDDDDDDDDDDDDDDDDDDDDDDDDDDD
DDDDDDDDDDDDDDDDDDDDDDDDDDDDDDDDDDDDDDDDDDDDDDDDDD
DDDDDDDDDDDDDDDDDDDDDDDDDDDDDDDDDDDDDDDDDDDDDDDDDD
DDDDDDDDDDDDDDDDDDDDDDDDDDDDDDDDDDDDDDDDDDDDDDDDDD
DDDDDDDDDDDDDDDDDDDDDDDDDDDDDDDDDDDDDDDDDDDDDDDDDD
DDDDDDDDDDDDDDDDDDDDDDDDDDDDDDDDDDDDDDDDDDDDDDDDDD
DDDDDDDDDDDDDDDDDDDDDDDDDDDDDDDDDDDDDDDDDDDDDDDDDD
DDDDDDDDDDDDDDDDDDDDDDDDDDDDDDDDDDDDDDDDDDDDDDDDDD
DDDDDDDDDDDDDDDDDDDDDDDDDDDDDDDDDDDDDDDDDDDDDDDDDD
DDDDDDDDDDDDDDDDDDDDDDDDDDDDDDDDDDDDDDDDDDDDDDDDDD
DDDDDDDDDDDDDDDDDDDDDDDDDDDDDDDDDDDDDDDDDDDDDDDDDD
DDDDDDDDDDDDDDDDDDDDDDDDDDDDDDDDDDDDDDDDDDDDDDDDDD
DDDDDDDDDDDDDDDDDDDDDDDDDDDDDDDDDDDDDDDDDDDDDDDDDD
DDDDDDDDDDDDDDDDDDDDDDDDDDDDDDDDDDDDDDDDDDDDDDDDDD
DDDDDDDDDDDDDDDDDDDDDDDDDDDDDDDDDDDDDDDDDDDDDDDDDD
DDDDDDDDDDDDDDDDDDDDDDDDDDDDDDDDDDDDDDDDDDDDDDDDDD
DDDDDDDDDDDDDDDDDDDDDDDDDDDDDDDDDDDDDDDDDDDDDDDDDD
DDDDDDDDDDDDDDDDDDDDDDDDDDDDDDDDDDDDDDDDDDDDDDDDDD
DDDDDDDDDDDDDDDDDDDDDDDDDDDDDDDDDDDDDDDDDDDDDDDDDD
DDDDDDDDDDDDDDDDDDDDDDDDDDDDDDDDDDDDDDDDDDDDDDDDDD
DDDDDDDDDDDDDDDDDDDDDDDDDDDDDDDDDDDDDDDDDDDDDDDDDD
DDDDDDDDDDDDDDDDDDDDDDDDDDDDDDDDDDDDDDDDDDDDDDDDDD
DDDDDDDDDDDDDDDDDDDDDDDDDDDDDDDDDDDDDDDDDDDDDDDDDD
DDDDDDDDDDDDDDDDDDDDDDDDDDDDDDDDDDDDDDDDDDDDDDDDDD
DDDDDDDDDDDDDDDDDDDDDDDDDDDDDDDDDDDDDDDDDDDDDDDDDD
DDDDDDDDDDDDDDDDDDDDDDDDDDDDDDDDDDDDDDDDDDDDDDDDDD
DDDDDDDDDDDDDDDDDDDDDDDDDDDDDDDDDDDDDDDDDDDDDDDDDD
DDDDDDDDDDDDDDDDDDDDDDDDDDDDDDDDDDDDDDDDDDDDDDDDDD
DDDDDDDDDDDDDDDDDDDDDDDDDDDDDDDDDDDDDDDDDDDDDDDDDD
DDDDDDDDDDDDDDDDDDDDDDDDDDDDDDDDDDDDDDDDDDDDDDDDDD
DDDDDDDDDDDDDDDDDDDDDDDDDDDDDDDDDDDDDDDDDDDDDDDDDD
DDDDDDDDDDDDDDDDDDDDDDDDDDDDDDDDDDDDDDDDDDDDDDDDDD
DDDDDDDDDDDDDDDDDDDDDDDDDDDDDDDDDDDDDDDDDDDDDDDDDD
DDDDDDDDDDDDDDDDDDDDDDDDDDDDDDDDDDDDDDDDDDDDDDDDDD
DDDDDDDDDDDDDDDDDDDDDDDDDDDDDDDDDDDDDDDDDDDDDDDDDD
DDDDDDDDDDDDDDDDDDDDDDDDDDDDDDDDDDDDDDDDDDDDDDDDDD
DDDDDDDDDDDDDDDDDDDDDDDDDDDDDDDDDDDDDDDDDDDDDDDDDD
DDDDDDDDDDDDDDDDDDDDDDDDDDDDDDDDDDDDDDDDDDDDDDDDDD
DDDDDDDDDDDDDDDDDDDDDDDDDDDDDDDDDDDDDDDDDDDDDDDDDD
DDDDDDDDDDDDDDDDDDDDDDDDDDDDDDDDDDDDDDDDDDDDDDDDDD
DDDDDDDDDDDDDDDDDDDDDDDDDDDDDDDDDDDDDDDDDDDDDDDDDD
DDDDDDDDDDDDDDDDDDDDDDDDDDDDDDDDDDDDDDDDDDDDDDDDDD
DDDDDDDDDDDDDDDDDDDDDDDDDDDDDDDDDDDDDDDDDDDDDDDDDD
DDDDDDDDDDDDDDDDDDDDDDDDDDDDDDDDDDDDDDDDDDDDDDDDDD
DDDDDDDDDDDDDDDDDDDDDDDDDDDDDDDDDDDDDDDDDDDDDDDDDD
DDDDDDDDDDDDDDDDDDDDDDDDDDDDDDDDDDDDDDDDDDDDDDDDDD
DDDDDDDDDDDDDDDDDDDDDDDDDDDDDDDDDDDDDDDDDDDDDDDDDD
DDDDDDDDDDDDDDDDDDDDDDDDDDDDDDDDDDDDDDDDDDDDDDDDDD
DDDDDDDDDDDDDDDDDDDDDDDDDDDDDDDDDDDDDDDDDDDDDDDDDD
DDDDDDDDDDDDDDDDDDDDDDDDDDDDDDDDDDDDDDDDDDDDDDDDDD
DDDDDDDDDDDDDDDDDDDDDDDDDDDDDDDDDDDDDDDDDDDDDDDDDD
DDDDDDDDDDDDDDDDDDDDDDDDDDDDDDDDDDDDDDDDDDDDDDDDDD
DDDDDDDDDDDDDDDDDDDDDDDDDDDDDDDDDDDDDDDDDDDDDDDDDD
DDDDDDDDDDDDDDDDDDDDDDDDDDDDDDDDDDDDDDDDDDDDDDDDDD
DDDDDDDDDDDDDDDDDDDDDDDDDDDDDDDDDDDDDDDDDDDDDDDDDD
DDDDDDDDDDDDDDDDDDDDDDDDDDDDDDDDDDDDDDDDDDDDDDDDDD
DDDDDDDDDDDDDDDDDDDDDDDDDDDDDDDDDDDDDDDDDDDDDDDDDD
DDDDDDDDDDDDDDDDDDDDDDDDDDDDDDDDDDDDDDDDDDDDDDDDDD
DDDDDDDDDDDDDDDDDDDDDDDDDDDDDDDDDDDDDDDDDDDDDDDDDD
DDDDDDDDDDDDDDDDDDDDDDDDDDDDDDDDDDDDDDDDDDDDDDDDDD
DDDDDDDDDDDDDDDDDDDDDDDDDDDDDDDDDDDDDDDDDDDDDDDDDD
DDDDDDDDDDDDDDDDDDDDDDDDDDDDDDDDDDDDDDDDDDDDDDDDDD
DDDDDDDDDDDDDDDDDDDDDDDDDDDDDDDDDDDDDDDDDDDDDDDDDD
DDDDDDDDDDDDDDDDDDDDDDDDDDDDDDDDDDDDDDDDDDDDDDDDDD
DDDDDDDDDDDDDDDDDDDDDDDDDDDDDDDDDDDDDDDDDDDDDDDDDD
DDDDDDDDDDDDDDDDDDDDDDDDDDDDDDDDDDDDDDDDDDDDDDDDDD
---
WWWWWWWWWWWWWWWWWWWWWWWWWWWWWWWWWWWWWWWWWWWWWWWWWW
WWWWWWWWWWWWWWWWWWWWWWW..WWWWWWWWWWWWWWWWWWWWWWWWW
WWWWWWWWWWWWWWWWWWWWW.....WWWWWWWWWWWWWWWWWWWWWWWW
WWWWWWWWWWWWWWWWWWW.......WWWWWWWWWWWWWWWWWWWWWWWW
WWWWWWWWWWWWWWWWW........WWWWWWWWWWWWWWWWWWWWWWWWW
WWWWWWWWWWWWWWWW.........WWWWWWWWWWWWWWWWWWWWWWWWW
WWWWWWWWWWWWWWWWW..........WWWWWWWWWWWWWWWWWWWWWWW
WWWWWWWWWWWWWWWW...........WWWWWWWWWWWWWWWWWWWWWWW
WWWWWWWWWWWWWWW..............WWWWWWWWWWWWWWWWWWWWW
WWWWWWWWWWWWWWWWW............WWWWWWWWWWWWWWWWWWWWW
WWWWWWWWWWWWWWWW..............WWWWWWWWWWWWWWWWWWWW
WWWWWWWWWWWWWWWWW.............WWWWWWWWWWWWWWWWWWWW
WWWWWWWWWWWWWWWW................WWWWWWWWWWWWWWWWWW
WWWWWWWWWWWWWW................WWWWWWWWWWWWWWWWWWWW
WWWWWWWWWWWWWWWW................WWWWWWWWWWWWWWWWWW
WWWWWWWWWWWWWWW...............WWWWWWWWWWWWWWWWWWWW
WWWWWWWWWWWWWW.................WWWWWWWWWWWWWWWWWWW
WWWWWWWWWWWWW....................WWWWWWWWWWWWWWWWW
WWWWWWWWWWW......................WWWWWWWWWWWWWWWWW
WWWWWWWWWWWWW....................WWWWWWWWWWWWWWWWW
WWWWWWWWWWW.....................WWWWWWWWWWWWWWWWWW
WWWWWWWWWW.......................WWWWWWWWWWWWWWWWW
WWWWWWWWWW......................WWWWWWWWWWWWWWWWWW
WWWWWWWWWWWW......................WWWWWWWWWWWWWWWW
WWWWWWWWWWWWW.......................WWWWWWWWWWWWWW
WWWWWWWWWWWWWWW......................WWWWWWWWWWWWW
WWWWWWWWWWWWWW.....................WWWWWWWWWWWWWWW
WWWWWWWWWWWW.......................WWWWWWWWWWWWWWW
WWWWWWWWWWW.........................WWWWWWWWWWWWWW
WWWWWWWWWWWWW.....................WWWWWWWWWWWWWWWW
WWWWWWWWWWWW....................WWWWWWWWWWWWWWWWWW
WWWWWWWWWW......................WWWWWWWWWWWWWWWWWW
WWWWWWWW........................WWWWWWWWWWWWWWWWWW
WWWWWWWW..........................WWWWWWWWWWWWWWWW
WWWWWWWWW...........................WWWWWWWWWWWWWW
WWWWWWWWW.........................WWWWWWWWWWWWWWWW
WWWWWWWW...........................WWWWWWWWWWWWWWW
WWWWWWWW.........................WWWWWWWWWWWWWWWWW
WWWWWWWW.........................WWWWWWWWWWWWWWWWW
WWWWWWW............................WWWWWWWWWWWWWWW
WWWWWW...........................WWWWWWWWWWWWWWWWW
WWWWW..........................WWWWWWWWWWWWWWWWWWW
WWWWWW..........................WWWWWWWWWWWWWWWWWW
WWWWWWWW......................WWWWWWWWWWWWWWWWWWWW
WWWWWWWWW....................WWWWWWWWWWWWWWWWWWWWW
WWWWWWW.......................WWWWWWWWWWWWWWWWWWWW
WWWWWWWW........................WWWWWWWWWWWWWWWWWW
WWWWWWWWW........................WWWWWWWWWWWWWWWWW
WWWWWWWW........................WWWWWWWWWWWWWWWWWW
WWWWWWWW........................WWWWWWWWWWWWWWWWWW
WWWWWWW........................WWWWWWWWWWWWWWWWWWW
WWWWWWWW.....................WWWWWWWWWWWWWWWWWWWWW
WWWWWWWWWW.....................WWWWWWWWWWWWWWWWWWW
WWWWWWWWWWWW...................WWWWWWWWWWWWWWWWWWW
WWWWWWWWWW....................WWWWWWWWWWWWWWWWWWWW
WWWWWWWW........................WWWWWWWWWWWWWWWWWW
WWWWWWWW..........................WWWWWWWWWWWWWWWW
WWWWWWWW........................WWWWWWWWWWWWWWWWWW
WWWWWWWWW......................WWWWWWWWWWWWWWWWWWW
WWWWWWW........................WWWWWWWWWWWWWWWWWWW
WWWWW..........................WWWWWWWWWWWWWWWWWWW
WWWW.........................WWWWWWWWWWWWWWWWWWWWW
WWWWW......................WWWWWWWWWWWWWWWWWWWWWWW
WWW......................WWWWWWWWWWWWWWWWWWWWWWWWW
WW.........................WWWWWWWWWWWWWWWWWWWWWWW
WW..........................WWWWWWWWWWWWWWWWWWWWWW
WW..........................WWWWWWWWWWWWWWWWWWWWWW
WWW........................WWWWWWWWWWWWWWWWWWWWWWW
WW...........................WWWWWWWWWWWWWWWWWWWWW
WWW.........................WWWWWWWWWWWWWWWWWWWWWW
WWWW.......................WWWWWWWWWWWWWWWWWWWWWWW
WWWWWW.......................WWWWWWWWWWWWWWWWWWWWW
WWWWWWWW.....................WWWWWWWWWWWWWWWWWWWWW
WWWWWWWWW.....................WWWWWWWWWWWWWWWWWWWW
WWWWWWWW........................WWWWWWWWWWWWWWWWWW
WWWWWW...........................WWWWWWWWWWWWWWWWW
WWWWWWWW..........................WWWWWWWWWWWWWWWW
WWWWWWWW............................WWWWWWWWWWWWWW
WWWWWWW...............................WWWWWWWWWWWW
WWWWW................................WWWWWWWWWWWWW
WWWWWW...............................WWWWWWWWWWWWW
WWWWW..................................WWWWWWWWWWW
WWWW...................................WWWWWWWWWWW
WWW...................................WWWWWWWWWWWW
WW......................................WWWWWWWWWW
WWWW....................................WWWWWWWWWW
WWWWWW....................................WWWWWWWW
WWWWWWWW................................WWWWWWWWWW
WWWWWWW................................WWWWWWWWWWW
WWWWW..................................WWWWWWWWWWW
WWWWW....................................WWWWWWWWW
WWWWWWW................................WWWWWWWWWWW
WWWWWW...............................WWWWWWWWWWWWW
WWWW................................WWWWWWWWWWWWWW
WWW..................................WWWWWWWWWWWWW
WWW................................WWWWWWWWWWWWWWW
WWWWW...............................WWWWWWWWWWWWWW
WWWWWWW............................WWWWWWWWWWWWWWW
WWWWW...............................WWWWWWWWWWWWWW
WWWWW.............................WWWWWWWWWWWWWWWW