DDDDDDDDDDDDDDDDDDDDDDDDDDDDDD
DDDDDDDDDDDDDDDDDDDDDDDDDDDDDD
DDDDDDDDDDDDDDDDDDDDDDDDDDDDDD
DDDDDDDDDDDDDDDDDDDDDDDDDDDDDD
DDDDDDDDDDDDDDDDDDDDDDDDDDDDDD
DDDDDDDDDDDDDDDDDDDDDDDDDDDDDD
DDDDDDDDDDDDDDDDDDDDDDDDDDDDDD
DDDDDDDDDDDDDDDDDDDDDDDDDDDDDD
DDDDDDDDDDDDDDDDDDDDDDDDDDDDDD
DDDDDDDDDDDDDDDDDDDDDDDDDDDDDD
DDDDDDDDDDDDDDDDDDDDDDDDDDDDDD
DDDDDDDDDDDDDDDDDDDDDDDDDDDDDD
DDDDDDDDDDDDDDDDDDDDDDDDDDDDDD
DDDDDDDDDDDDDDDDDDDDDDDDDDDDDD
DDDDDDDDDDDDDDDDDDDDDDDDDDDDDD
DDDDDDDDDDDDDDDDDDDDDDDDDDDDDD
DDDDDDDDDDDDDDDDDDDDDDDDDDDDDD
DDDDDDDDDDDDDDDDDDDDDDDDDDDDDD
DDDDDDDDDDDDDDDDDDDDDDDDDDDDDD
DDDDDDDDDDDDDDDDDDDDDDDDDDDDDD
DDDDDDDDDDDDDDDDDDDDDDDDDDDDDD
DDDDDDDDDDDDDDDDDDDDDDDDDDDDDD
DDDDDDDDDDDDDDDDDDDDDDDDDDDDDD
DDDDDDDDDDDDDDDDDDDDDDDDDDDDDD
DDDDDDDDDDDDDDDDDDDDDDDDDDDDDD
DDDDDDDDDDDDDDDDDDDDDDDDDDDDDD
DDDDDDDDDDDDDDDDDDDDDDDDDDDDDD
DDDDDDDDDDDDDDDDDDDDDDDDDDDDDD
DDDDDDDDDDDDDDDDDDDDDDDDDDDDDD
DDDDDDDDDDDDDDDDDDDDDDDDDDDDDD
---
WWWWWWWWWW.............WWWWWWW
WWWWWWWWWWWW............WWWWWW
WWWWWWWWWWWW...........WWWWWWW
WWWWWWWWWW...............WWWWW
WWWWWWWWW..................WWW
WWWWWWW.....................WW
WWWWWW......................WW
WWWWWW....................WWWW
WWWWWW...................WWWWW
WWWWWW..................WWWWWW
WWWW..................WWWWWWWW
WWWWWW..............WWWWWWWWWW
WWWW................WWWWWWWWWW
WWW................WWWWWWWWWWW
WWWW................WWWWWWWWWW
WW.................WWWWWWWWWWW
WW.................WWWWWWWWWWW
WWW.................WWWWWWWWWW
WWW...............WWWWWWWWWWWW
WWW.................WWWWWWWWWW
WWWWW..............WWWWWWWWWWW
WWWWW...............WWWWWWWWWW
WWWW..............WWWWWWWWWWWW
WWWW...............WWWWWWWWWWW
WWWW.................WWWWWWWWW
WWWWWW................WWWWWWWW
WWWWWWWW..............WWWWWWWW
WWWWWW...............WWWWWWWWW
WWWWWWW................WWWWWWW
WWWWWWW................WWWWWWW