DDDDQQQQQQQQQQQQQQQQQQQQQQQQQQ
DDDDDDQQQQQQQQQQQQQQQQQQQQQQQQ
DDDDDDDQQQQQQQQQQQQQQQQQQQQQQQ
DDDDDDDDDQQQQQQQQQQQQQQQQQQQQQ
DDDDDDDDDDQQQQQQQQQQQQQQQQQQQQ
DDDDDDDDDDDQQQQQQQQQQQQQQQQQQQ
DDDDDDDDDDDDDQQQQQQQQQQQQQQWWW
DDDDDDDDDDDDDDQQQQQQQQQQQWWWWW
DDDDDDDDDDDDDDDQQQQQQQQQWWWWWW
DDDDDDDDDDDDDDDDQQQQQQQWWWWWWW
DDDDDDDDDDDDDDDDQQQQQQWWWWWWWW
DDDDDDDDDDDDDDDDQQQQQQWWWWWWWW
DDDDDDDDDDDDDDDDQQQQQQWWWWWWWW
DDDDDDDDDDDDDDDDQQQQQWWWWWWWWW
DDDDDDDDDDDDDDDDQQQQQWWWWWWWWW
DDDDDDDDDDDDDDDDQQQQWWWWWWWWWW
DDDDDDDDDDDDDDDQQQQQWWWWWWWWWW
DDDDDDDDDDDDDDDQQQQWWWWWWWWWWW
DDDDDDDDDDDDDDQQQQQWWWWWWWWWWW
DDDDDDDDDDDDDQQQQQWWWWWWWWWWWW
DDDDDDDDDDDDQQQQQQWWWWWWWWWWWW
DDDDDDDDDDDQQQQQQWWWWWWWWWWWWW
DDDDDDDDDDQQQQQQWWWWWWWWWWWWWW
DDDDDDDDDQQQQQQQWWWWWWWWWWWWWW
DDDDDDDQQQQQQQQWWWWWWWWWWWWWWW
DDDDDDQQQQQQQQWWWWWWWWWWWWWWWW
DDDDDQQQQQQQQWWWWWWWWWWWWWWWWW
DDDDQQQQQQQQQWWWWWWWWWWWWWWWWW
DDDQQQQQQQQQWWWWWWWWWWWWWWWWWW
DQQQQQQQQQQWWWWWWWWWWWWWWWWWWW
---
..............................
..............................
..............................
..............................
..............................
..............................
..............................
..............................
..............................
..............................
..............................
..............................
..............................
..............................
..............................
..............................
..............................
..............................
..............................
..............................
..............................
..............................
..............................
..............................
..............................
..............................
..............................
..............................
..............................
..............................