QQQDDDDDDDDDDDDDQQQD
DDDDDDDDDDDDDDDDQDDD
DDDDDDDDDDDDDDDDDDDD
DDDDDDDDDDDDDDDDDDDD
DDDDDDDDDDDDDDDDDDDD
DDDDDDDDDDDDDDDDDDDD
DDDDDDDDDDDDDDDDDDDD
DDDDDDDDDDDDDDDDDDDD
DDDDDDDDDDDDDDDDDDDD
DDDDDDDDDDDDDDDDDDDD
DDDDDDDDDDDDDDDDDDDD
DDDDDDDDDDDDDDDDDDDD
DDDDDDDDDDDDDDDDDDDD
DDDDDDDDDDDDDDDDDDDD
DDDDDDDDWSBDDDDDDDDD
DDDDDDDDWSBDDDDDDDDD
DDDDDDDDWSBDDDDDDDDD
DDDDDDDDDDBDDDDDDDDD
DDDDDDDDDDDDDDDDDDDD
QQQDDDDDDDDDDDQQQDDD
---
WWWWWWWWWWW.WWWWWWWW
WWWWWWWWW.WWWWWWWWWW
WWWWWWWW..WWWWWWWWWW
WWWWWW...WWWWWWWWWWW
WWWWWW..WWWWWWWWWWWW
WWWWWWWW.WWWWWWWWWWW
WWWWWWW..WWWWWWWWWWW
WWWWWWW...WWWWWWWWWW
WWWWWWW.....WWWWWWWW
WWWWWWWWW....WWWWWWW
WWWWWWWWW....WWWWWWW
WWWWWWWWW...WWWWWWWW
WWWWWWWWWW...WWWWWWW
WWWWWWWW.......WWWWW
WWWWWW...........WWW
WWWW............WWWW
WWW...............WW
WW................WW
WW................WW
WW................WW