QQQQQQQWWWWWWWWWWWWWWWWWWWWWWW
QQQQQQQWWWWWWWWWWWWWWWWWWWWWWW
QQQQQQQQWWWWWWWWWWWWWWWWWWWWWW
QQQQQQQQWWWWWWWWWWWWWWWWWWWWWW
QQQQQQQQQWWWWWWWWWWWWWWWWWWWWW
QQQQQQQQQQWWWWWWWWWWWWWWWWWWWW
QQQQQQQQQQWWWWWWWWWWWWWWWWWWWW
QQQQQQQQQQQWWWWWWWWWWWWWWWWWWQ
QQQQQQQQQQQQWWWWWWWWWWWWWWWWQQ
DDQQQQQQQQQQQWWWWWWWWWWWWWWQQQ
DDDDQQQQQQQQQQWWWWWWWWWWWWQQQQ
DDDDDQQQQQQQQQQWWWWWWWWWWQQQQQ
DDDDDDQQQQQQQQQQQWWWWWWWQQQQQQ
DDDDDDDQQQQQQQQQQQQQWQQQQQQQQQ
DDDDDDDDQQQQQQQQQQQQQQQQQQQQQQ
DDDDDDDDDQQQQQQQQQQQQQQQQQQQQQ
DDDDDDDDDDDQQQQQQQQQQQQQQQQQQQ
DDDDDDDDDDDDQQQQQQQQQQQQQQQQQQ
DDDDDDDDDDDDDQQQQQQQQQQQQQQQQQ
DDDDDDDDDDDDDDQQQQQQQQQQQQQQQQ
DDDDDDDDDDDDDDDQQQQQQQQQQQQQQQ
DDDDDDDDDDDDDDDDQQQQQQQQQQQQQQ
DDDDDDDDDDDDDDDDDQQQQQQQQQQQQQ
DDDDDDDDDDDDDDDDDDQQQQQQQQQQQQ
DDDDDDDDDDDDDDDDDDDQQQQQQQQQQQ
DDDDDDDDDDDDDDDDDDDQQQQQQQQQQQ
DDDDDDDDDDDDDDDDDDDQQQQQQQQQQQ
DDDDDDDDDDDDDDDDDDDDQQQQQQQQQQ
DDDDDDDDDDDDDDDDDDDQQQQQQQQQQQ
DDDDDDDDDDDDDDDDDDDQQQQQQQQQQQ
DDDDDDDDDDDDDDDDDDDQQQQQQQQQQQ
DDDDDDDDDDDDDDDDDDDQQQQQQQQQQQ
DDDDDDDDDDDDDDDDDDQQQQQQQQQQQQ
DDDDDDDDDDDDDDDDDDQQQQQQQQQQQQ
DDDDDDDDDDDDDDDDDQQQQQQQQQQQQQ
DDDDDDDDDDDDDDDDQQQQQQQQQQQQQQ
DDDDDDDDDDDDDDDDQQQQQQQQQQWWWW
DDDDDDDDDDDDDDDQQQQQQQQQWWWWWW
DDDDDDDDDDDDDQQQQQQQQQQWWWWWWW
QDDDDDDDDDDDQQQQQQQQQQWWWWWWWW
---
..............................
..............................
..............................
..............................
..............................
..............................
..............................
..............................
..............................
..............................
..............................
..............................
..............................
..............................
..............................
..............................
..............................
..............................
..............................
..............................
..............................
..............................
..............................
..............................
..............................
..............................
..............................
..............................
..............................
..............................
..............................
..............................
..............................
..............................
..............................
..............................
..............................
..............................
..............................
..............................