DDDDDDDDDDDDDDDDDDDDDDDDDDDDDDDDDDDDDDDDDDDDDDDDDDDDDDDDDDDD
DDDDDDDDDDDDDDDDDDDDDDDDDDDDDDDDDDDDDDDDDDDDDDDDDDDDDDDDDDDD
DDDDDDDDDDDDDDDDDDDDDDDDDDDDDDDDDDDDDDDDDDDDDDDDDDDDDDDDDDDD
DDDDDDDDDDDDDDDDDDDDDDDDDDDDDDDDDDDDDDDDDDDDDDDDDDDDDDDDDDDD
DDDDDDDDDDDDDDDDDDDDDDDDDDDDDDDDDDDDDDDDDDDDDDDDDDDDDDDDDDDD
DDDDDDDDDDDDDDDDDDDDDDDDDDDDDDDDDDDDDDDDDDDDDDDDDDDDDDDDDDDD
DDDDDDDDDDDDDDDDDDDDDDDDDDDDDDDDDDDDDDDDDDDDDDDDDDDDDDDDDDDD
DDDDDDDDDDDDDDDDDDDDDDDDDDDDDDDDDDDDDDDDDDDDDDDDDDDDDDDDDDDD
DDDDDDDDDDDDDDDDDDDDDDDDDDDDDDDDDDDDDDDDDDDDDDDDDDDDDDDDDDDD
DDDDDDDDDDDDDDDDDDDDDDDDDDDDDDDDDDDDDDDDDDDDDDDDDDDDDDDDDDDD
DDDDDDDDDDDDDDDDDDDDDDDDDDDDDDDDDDDDDDDDDDDDDDDDDDDDDDDDDDDD
DDDDDDDDDDDDDDDDDDDDDDDDDDDDDDDDDDDDDDDDDDDDDDDDDDDDDDDDDDDD
DDDDDDDDDDDDDDDDDDDDDDDDDDDDDDDDDDDDDDDDDDDDDDDDDDDDDDDDDDDD
DDDDDDDDDDDDDDDDDDDDDDDDDDDDDDDDDDDDDDDDDDDDDDDDDDDDDDDDDDDD
DDDDDDDDDDDDDDDDDDDDDDDDDDDDDDDDDDDDDDDDDDDDDDDDDDDDDDDDDDDD
DDDDDDDDDDDDDDDDDDDDDDDDDDDDDDDDDDDDDDDDDDDDDDDDDDDDDDDDDDDD
DDDDDDDDDDDDDDDDDDDDDDDDDDDDDDDDDDDDDDDDDDDDDDDDDDDDDDDDDDDD
DDDDDDDDDDDDDDDDDDDDDDDDDDDDDDDDDDDDDDDDDDDDDDDDDDDDDDDDDDDD
DDDDDDDDDDDDDDDDDDDDDDDDDDDDDDDDDDDDDDDDDDDDDDDDDDDDDDDDDDDD
DDDDDDDDDDDDDDDDDDDDDDDDDDDDDDDDDDDDDDDDDDDDDDDDDDDDDDDDDDDD
DDDDDDDDDDDDDDDDDDDDDDDDDDDDDDDDDDDDDDDDDDDDDDDDDDDDDDDDDDDD
DDDDDDDDDDDDDDDDDDDDDDDDDDDDDDDDDDDDDDDDDDDDDDDDDDDDDDDDDDDD
DDDDDDDDDDDDDDDDDDDDDDDDDDDDDDDDDDDDDDDDDDDDDDDDDDDDDDDDDDDD
DDDDDDDDDDDDDDDDDDDDDDDDDDDDDDDDDDDDDDDDDDDDDDDDDDDDDDDDDDDD
DDDDDDDDDDDDDDDDDDDDDDDDDDDDDDDDDDDDDDDDDDDDDDDDDDDDDDDDDDDD
DDDDDDDDDDDDDDDDDDDDDDDDDDDDDDDDDDDDDDDDDDDDDDDDDDDDDDDDDDDD
DDDDDDDDDDDDDDDDDDDDDDDDDDDDDDDDDDDDDDDDDDDDDDDDDDDDDDDDDDDD
DDDDDDDDDDDDDDDDDDDDDDDDDDDDDDDDDDDDDDDDDDDDDDDDDDDDDDDDDDDD
DDDDDDDDDDDDDDDDDDDDDDDDDDDDDDDDDDDDDDDDDDDDDDDDDDDDDDDDDDDD
DDDDDDDDDDDDDDDDDDDDDDDDDDDDDDDDDDDDDDDDDDDDDDDDDDDDDDDDDDDD
DDDDDDDDDDDDDDDDDDDDDDDDDDDDDDDDDDDDDDDDDDDDDDDDDDDDDDDDDDDD
DDDDDDDDDDDDDDDDDDDDDDDDDDDDDDDDDDDDDDDDDDDDDDDDDDDDDDDDDDDD
DDDDDDDDDDDDDDDDDDDDDDDDDDDDDDDDDDDDDDDDDDDDDDDDDDDDDDDDDDDD
DDDDDDDDDDDDDDDDDDDDDDDDDDDDDDDDDDDDDDDDDDDDDDDDDDDDDDDDDDDD
DDDDDDDDDDDDDDDDDDDDDDDDDDDDDDDDDDDDDDDDDDDDDDDDDDDDDDDDDDDD
DDDDDDDDDDDDDDDDDDDDDDDDDDDDDDDDDDDDDDDDDDDDDDDDDDDDDDDDDDDD
DDDDDDDDDDDDDDDDDDDDDDDDDDDDDDDDDDDDDDDDDDDDDDDDDDDDDDDDDDDD
DDDDDDDDDDDDDDDDDDDDDDDDDDDDDDDDDDDDDDDDDDDDDDDDDDDDDDDDDDDD
DDDDDDDDDDDDDDDDDDDDDDDDDDDDDDDDDDDDDDDDDDDDDDDDDDDDDDDDDDDD
DDDDDDDDDDDDDDDDDDDDDDDDDDDDDDDDDDDDDDDDDDDDDDDDDDDDDDDDDDDD
DDDDDDDDDDDDDDDDDDDDDDDDDDDDDDDDDDDDDDDDDDDDDDDDDDDDDDDDDDDD
DDDDDDDDDDDDDDDDDDDDDDDDDDDDDDDDDDDDDDDDDDDDDDDDDDDDDDDDDDDD
DDDDDDDDDDDDDDDDDDDDDDDDDDDDDDDDDDDDDDDDDDDDDDDDDDDDDDDDDDDD
DDDDDDDDDDDDDDDDDDDDDDDDDDDDDDDDDDDDDDDDDDDDDDDDDDDDDDDDDDDD
DDDDDDDDDDDDDDDDDDDDDDDDDDDDDDDDDDDDDDDDDDDDDDDDDDDDDDDDDDDD
DDDDDDDDDDDDDDDDDDDDDDDDDDDDDDDDDDDDDDDDDDDDDDDDDDDDDDDDDDDD
DDDDDDDDDDDDDDDDDDDDDDDDDDDDDDDDDDDDDDDDDDDDDDDDDDDDDDDDDDDD
DDDDDDDDDDDDDDDDDDDDDDDDDDDDDDDDDDDDDDDDDDDDDDDDDDDDDDDDDDDD
DDDDDDDDDDDDDDDDDDDDDDDDDDDDDDDDDDDDDDDDDDDDDDDDDDDDDDDDDDDD
DDDDDDDDDDDDDDDDDDDDDDDDDDDDDDDDDDDDDDDDDDDDDDDDDDDDDDDDDDDD
DDDDDDDDDDDDDDDDDDDDDDDDDDDDDDDDDDDDDDDDDDDDDDDDDDDDDDDDDDDD
DDDDDDDDDDDDDDDDDDDDDDDDDDDDDDDDDDDDDDDDDDDDDDDDDDDDDDDDDDDD
DDDDDDDDDDDDDDDDDDDDDDDDDDDDDDDDDDDDDDDDDDDDDDDDDDDDDDDDDDDD
DDDDDDDDDDDDDDDDDDDDDDDDDDDDDDDDDDDDDDDDDDDDDDDDDDDDDDDDDDDD
DDDDDDDDDDDDDDDDDDDDDDDDDDDDDDDDDDDDDDDDDDDDDDDDDDDDDDDDDDDD
DDDDDDDDDDDDDDDDDDDDDDDDDDDDDDDDDDDDDDDDDDDDDDDDDDDDDDDDDDDD
DDDDDDDDDDDDDDDDDDDDDDDDDDDDDDDDDDDDDDDDDDDDDDDDDDDDDDDDDDDD
DDDDDDDDDDDDDDDDDDDDDDDDDDDDDDDDDDDDDDDDDDDDDDDDDDDDDDDDDDDD
DDDDDDDDDDDDDDDDDDDDDDDDDDDDDDDDDDDDDDDDDDDDDDDDDDDDDDDDDDDD
DDDDDDDDDDDDDDDDDDDDDDDDDDDDDDDDDDDDDDDDDDDDDDDDDDDDDDDDDDDD
---
WWWWWWWWWWWWWWWWWW.......................WWWWWWWWWWWWWWWWWWW
WWWWWWWWWWWWWWWWWWW......................WWWWWWWWWWWWWWWWWWW
WWWWWWWWWWWWWWWWW......................WWWWWWWWWWWWWWWWWWWWW
WWWWWWWWWWWWWWWWWWW.....................WWWWWWWWWWWWWWWWWWWW
WWWWWWWWWWWWWWWWWW......................WWWWWWWWWWWWWWWWWWWW
WWWWWWWWWWWWWWWW.......................WWWWWWWWWWWWWWWWWWWWW
WWWWWWWWWWWWWWWW......................WWWWWWWWWWWWWWWWWWWWWW
WWWWWWWWWWWWWWWWWW......................WWWWWWWWWWWWWWWWWWWW
WWWWWWWWWWWWWWWWW.......................WWWWWWWWWWWWWWWWWWWW
WWWWWWWWWWWWWWWWWW......................WWWWWWWWWWWWWWWWWWWW
WWWWWWWWWWWWWWWWWWWW...................WWWWWWWWWWWWWWWWWWWWW
WWWWWWWWWWWWWWWWWW.......................WWWWWWWWWWWWWWWWWWW
WWWWWWWWWWWWWWWWWWW........................WWWWWWWWWWWWWWWWW
WWWWWWWWWWWWWWWWW...........................WWWWWWWWWWWWWWWW
WWWWWWWWWWWWWWWWWWW.........................WWWWWWWWWWWWWWWW
WWWWWWWWWWWWWWWWWWWW.........................WWWWWWWWWWWWWWW
WWWWWWWWWWWWWWWWWWW.........................WWWWWWWWWWWWWWWW
WWWWWWWWWWWWWWWWWW..........................WWWWWWWWWWWWWWWW
WWWWWWWWWWWWWWWWWW..........................WWWWWWWWWWWWWWWW
WWWWWWWWWWWWWWWWWWWW..........................WWWWWWWWWWWWWW
WWWWWWWWWWWWWWWWWWWWW........................WWWWWWWWWWWWWWW
WWWWWWWWWWWWWWWWWWW........................WWWWWWWWWWWWWWWWW
WWWWWWWWWWWWWWWWWWWWW.....................WWWWWWWWWWWWWWWWWW
WWWWWWWWWWWWWWWWWWWWWW....................WWWWWWWWWWWWWWWWWW
WWWWWWWWWWWWWWWWWWWWWWW...................WWWWWWWWWWWWWWWWWW
WWWWWWWWWWWWWWWWWWWWW....................WWWWWWWWWWWWWWWWWWW
WWWWWWWWWWWWWWWWWWW....................WWWWWWWWWWWWWWWWWWWWW
WWWWWWWWWWWWWWWWWWWWW................WWWWWWWWWWWWWWWWWWWWWWW
WWWWWWWWWWWWWWWWWWWW...............WWWWWWWWWWWWWWWWWWWWWWWWW
WWWWWWWWWWWWWWWWWWWW.............WWWWWWWWWWWWWWWWWWWWWWWWWWW
WWWWWWWWWWWWWWWWWW.................WWWWWWWWWWWWWWWWWWWWWWWWW
WWWWWWWWWWWWWWWW..................WWWWWWWWWWWWWWWWWWWWWWWWWW
WWWWWWWWWWWWWW....................WWWWWWWWWWWWWWWWWWWWWWWWWW
WWWWWWWWWWWWW.......................WWWWWWWWWWWWWWWWWWWWWWWW
WWWWWWWWWWWW.......................WWWWWWWWWWWWWWWWWWWWWWWWW
WWWWWWWWWW.........................WWWWWWWWWWWWWWWWWWWWWWWWW
WWWWWWWWWWW......................WWWWWWWWWWWWWWWWWWWWWWWWWWW
WWWWWWWWWW.....................WWWWWWWWWWWWWWWWWWWWWWWWWWWWW
WWWWWWWWWWWW...................WWWWWWWWWWWWWWWWWWWWWWWWWWWWW
WWWWWWWWWWWWWW.................WWWWWWWWWWWWWWWWWWWWWWWWWWWWW
WWWWWWWWWWWWWWWW..............WWWWWWWWWWWWWWWWWWWWWWWWWWWWWW
WWWWWWWWWWWWWWWWW...............WWWWWWWWWWWWWWWWWWWWWWWWWWWW
WWWWWWWWWWWWWWW...................WWWWWWWWWWWWWWWWWWWWWWWWWW
WWWWWWWWWWWWWW.....................WWWWWWWWWWWWWWWWWWWWWWWWW
WWWWWWWWWWWWWWWW.....................WWWWWWWWWWWWWWWWWWWWWWW
WWWWWWWWWWWWWW.......................WWWWWWWWWWWWWWWWWWWWWWW
WWWWWWWWWWWW........................WWWWWWWWWWWWWWWWWWWWWWWW
WWWWWWWWWWWWW.....................WWWWWWWWWWWWWWWWWWWWWWWWWW
WWWWWWWWWWWWWW....................WWWWWWWWWWWWWWWWWWWWWWWWWW
WWWWWWWWWWWWWW.....................WWWWWWWWWWWWWWWWWWWWWWWWW
WWWWWWWWWWWWWWWW..................WWWWWWWWWWWWWWWWWWWWWWWWWW
WWWWWWWWWWWWWWW.....................WWWWWWWWWWWWWWWWWWWWWWWW
WWWWWWWWWWWWWWWW.....................WWWWWWWWWWWWWWWWWWWWWWW
WWWWWWWWWWWWWWWWW....................WWWWWWWWWWWWWWWWWWWWWWW
WWWWWWWWWWWWWWW......................WWWWWWWWWWWWWWWWWWWWWWW
WWWWWWWWWWWWWWWW......................WWWWWWWWWWWWWWWWWWWWWW
WWWWWWWWWWWWWWWWW.....................WWWWWWWWWWWWWWWWWWWWWW
WWWWWWWWWWWWWWWWWW.....................WWWWWWWWWWWWWWWWWWWWW
WWWWWWWWWWWWWWWWW....................WWWWWWWWWWWWWWWWWWWWWWW
WWWWWWWWWWWWWWWW...................WWWWWWWWWWWWWWWWWWWWWWWWW