DDDDDDDDDDDDDDDDDDDDDDDDDDDDDDDDDDDDDDDD
DDDDDDDDDDDDDDDDDDDDDDDDDDDDDDDDDDDDDDDD
DDDDDDDDDDDDDDDDDDDDDDDDDDDDDDDDDDDDDDDD
DDDDDDDDDDDDDDDDDDDDDDDDDDDDDDDDDDDDDDDD
DDDDDDDDDDDDDDDDDDDDDDDDDDDDDDDDDDDDDDDD
DDDDDDDDDDDDDDDDDDDDDDDDDDDDDDDDDDDDDDDD
DDDDDDDDDDDDDDDDDDDDDDDDDDDDDDDDDDDDDDDD
DDDDDDDDDDDDDDDDDDDDDDDDDDDDDDDDDDDDDDDD
DDDDDDDDDDDDDDDDDDDDDDDDDDDDDDDDDDDDDDDD
DDDDDDDDDDDDDDDDDDDDDDDDDDDDDDDDDDDDDDDD
DDDDDDDDDDDDDDDDDDDDDDDDDDDDDDDDDDDDDDDD
DDDDDDDDDDDDDDDDDDDDDDDDDDDDDDDDDDDDDDDD
DDDDDDDDDDDDDDDDDDDDDDDDDDDDDDDDDDDDDDDD
DDDDDDDDDDDDDDDDDDDDDDDDDDDDDDDDDDDDDDDD
DDDDDDDDDDDDDDDDDDDDDDDDDDDDDDDDDDDDDDDD
DDDDDDDDDDDDDDDDDDDDDDDDDDDDDDDDDDDDDDDD
DDDDDDDDDDDDDDDDDDDDDDDDDDDDDDDDDDDDDDDD
DDDDDDDDDDDDDDDDDDDDDDDDDDDDDDDDDDDDDDDD
DDDDDDDDDDDDDDDDDDDDDDDDDDDDDDDDDDDDDDDD
DDDDDDDDDDDDDDDDDDDDDDDDDDDDDDDDDDDDDDDD
DDDDDDDDDDDDDDDDDDDDDDDDDDDDDDDDDDDDDDDD
DDDDDDDDDDDDDDDDDDDDDDDDDDDDDDDDDDDDDDDD
DDDDDDDDDDDDDDDDDDDDDDDDDDDDDDDDDDDDDDDD
DDDDDDDDDDDDDDDDDDDDDDDDDDDDDDDDDDDDDDDD
DDDDDDDDDDDDDDDDDDDDDDDDDDDDDDDDDDDDDDDD
DDDDDDDDDDDDDDDDDDDDDDDDDDDDDDDDDDDDDDDD
DDDDDDDDDDDDDDDDDDDDDDDDDDDDDDDDDDDDDDDD
DDDDDDDDDDDDDDDDDDDDDDDDDDDDDDDDDDDDDDDD
DDDDDDDDDDDDDDDDDDDDDDDDDDDDDDDDDDDDDDDD
DDDDDDDDDDDDDDDDDDDDDDDDDDDDDDDDDDDDDDDD
DDDDDDDDDDDDDDDDDDDDDDDDDDDDDDDDDDDDDDDD
DDDDDDDDDDDDDDDDDDDDDDDDDDDDDDDDDDDDDDDD
DDDDDDDDDDDDDDDBDDDDDDDDDDDDDDDDDDDDDDDD
DDDDDDDDDDDDDDDBDDDDDDDDDDDDDDDDDDDDDDDD
DDDDDDDDDDDDBBBBDDDDDDDDDDDDDDDDDDDDDDDD
DDDDDDDDDDDDBDBBBDDDDDDDDDDDDDDDDDDDDDDD
DDDDDDDDDDDBDDBDDDDDDDDDDDDDDDDDDDDDDDDD
DDDDDDDDDDBDDDBDDDDDDDDDDDDDDDDDDDDDDDDD
DDDDDDDDDDDDDDBDDDDDDDDDDDDDDDDDDDDDDDDD
DDDDDDDDDSSSSSDDDDDDDDDDDDDDDDDDDDDDDDDD
DDDDDDDDDDDDDSDDDDDDDDDDDDDDDDDDDDDDDDDD
DDDDDDDDDDDDDDDDDDDDDDDDDDDDDDDDDDDDDDDD
DDDDDDDDDDDDDDDDQQDDDDDDDDDDDDDDDDDDDDDD
DDDDDDDDDDDDDDDQDQDDDDDDDDDDDDDDDDDDDDDD
DDDDDDDDDDDDQQQQQDDDDDDDDDDDDDDDDDDDDDDD
DDDDDDDDDDDDDDDDDDDDDDDDDDDDDDDDDDDDDDDD
DDDDDDDDDDDDDDDDDDDDDDDDDDDDDDDDDDDDDDDD
DDDDDDDDDDDDDDDDDDDDDDDDDDDDDDDDDDDDDDDD
DDDDDDDDDDDDDDDDDDDDDDDDDDDDDDDDDDDDDDDD
DDDDDDDDDDDDDDDDDDDDDDDDDDDDDDDDDDDDDDDD
DDDDDDDDDDDDDDDDDDDDDDDDDDDDDDDDDDDDDDDD
DDDDDDDDDDDDDDDDDDDDDDDDDDDDDDDDDDDDDDDD
DDDDDDDDDDDDDDDDDDDDDDDDDDDDDDDDDDDDDDDD
DDDDDDDDDDDDDDDDDDDDDDDDDDDDDDDDDDDDDDDD
DDDDDDDDDDDDDDDDDDDDDDDDDDDDDDDDDDDDDDDD
DDDDDDDDDDDDDDDDDDDDDDDDDDDDDDDDDDDDDDDD
DDDDDDDDDDDDDDDDDDDDDDDDDDDDDDDDDDDDDDDD
DDDDDDDDDDDDDDDDDDDDDDDDDDDDDDDDDDDDDDDD
DDDDDDDDDDDDDDDDDDDDDDDDDDDDDDDDDDDDDDDD
DDDDDDDDDDDDDDDDDDDDDDDDDDDDDDDDDDDDDDDD
DDDDDDDDDDDDDDDDDDDDDDDDDDDDDDDDDDDDDDDD
DDDDDDDDDDDDDDDDDDDDDDDDDDDDDDDDDDDDDDDD
DDDDDDDDDDDDDDDDDDDDDDDDDDDDDDDDDDDDDDDD
DDDDDDDDDDDDDDDDDDDDDDDDDDDDDDDDDDDDDDDD
DDDDDDDDDDDDDDDDDDDDDDDDDDDDDDDDDDDDDDDD
DDDDDDDDDDDDDDDDDDDDDDDDDDDDDDDDDDDDDDDD
DDDDDDDDDDDDDDDDDDDDDDDDDDDDDDDDDDDDDDDD
DDDDDDDDDDDDDDDDDDDDDDDDDDDDDDDDDDDDDDDD
DDDDDDDDDDDDDDDDDDDDDDDDDDDDDDDDDDDDDDDD
DDDDDDDDDDDDDDDDDDDDDDDDDDDDDDDDDDDDDDDD
---
WWWWWWWWWWWWW....WWWWWWWWWWWWWWWWWWWWWWW
WWWWWWWWWWWWWWW....WWWWWWWWWWWWWWWWWWWWW
WWWWWWWWWWWWWWWW.....WWWWWWWWWWWWWWWWWWW
WWWWWWWWWWWWWWW....WWWWWWWWWWWWWWWWWWWWW
WWWWWWWWWWWWW......WWWWWWWWWWWWWWWWWWWWW
WWWWWWWWWWWWWWW..WWWWWWWWWWWWWWWWWWWWWWW
WWWWWWWWWWWWWW.....WWWWWWWWWWWWWWWWWWWWW
WWWWWWWWWWWW........WWWWWWWWWWWWWWWWWWWW
WWWWWWWWWWW..........WWWWWWWWWWWWWWWWWWW
WWWWWWWWW.............WWWWWWWWWWWWWWWWWW
WWWWWWWWWW.............WWWWWWWWWWWWWWWWW
WWWWWWWWWWWW.........WWWWWWWWWWWWWWWWWWW
WWWWWWWWWWWWWW......WWWWWWWWWWWWWWWWWWWW
WWWWWWWWWWWW........WWWWWWWWWWWWWWWWWWWW
WWWWWWWWWWWW......WWWWWWWWWWWWWWWWWWWWWW
WWWWWWWWWWW.......WWWWWWWWWWWWWWWWWWWWWW
WWWWWWWWW.........WWWWWWWWWWWWWWWWWWWWWW
WWWWWWWWWWW.....WWWWWWWWWWWWWWWWWWWWWWWW
WWWWWWWWWW........WWWWWWWWWWWWWWWWWWWWWW
WWWWWWWWWWWW........WWWWWWWWWWWWWWWWWWWW
WWWWWWWWWWWW........WWWWWWWWWWWWWWWWWWWW
WWWWWWWWWWWW.........WWWWWWWWWWWWWWWWWWW
WWWWWWWWWWWW..........WWWWWWWWWWWWWWWWWW
WWWWWWWWWWWWWW..........WWWWWWWWWWWWWWWW
WWWWWWWWWWWWW.........WWWWWWWWWWWWWWWWWW
WWWWWWWWWWWWWW.......WWWWWWWWWWWWWWWWWWW
WWWWWWWWWWWWWWW.....WWWWWWWWWWWWWWWWWWWW
WWWWWWWWWWWWWWWW...WWWWWWWWWWWWWWWWWWWWW
WWWWWWWWWWWWWWWW..WWWWWWWWWWWWWWWWWWWWWW
WWWWWWWWWWWWWW.....WWWWWWWWWWWWWWWWWWWWW
WWWWWWWWWWWWWW.......WWWWWWWWWWWWWWWWWWW
WWWWWWWWWWWW........WWWWWWWWWWWWWWWWWWWW
WWWWWWWWWW...........WWWWWWWWWWWWWWWWWWW
WWWWWWWWW...........WWWWWWWWWWWWWWWWWWWW
WWWWWWWW..........WWWWWWWWWWWWWWWWWWWWWW
WWWWWWWWWW.......WWWWWWWWWWWWWWWWWWWWWWW
WWWWWWWW.........WWWWWWWWWWWWWWWWWWWWWWW
WWWWWWWWW..........WWWWWWWWWWWWWWWWWWWWW
WWWWWWWW.........WWWWWWWWWWWWWWWWWWWWWWW
WWWWWW............WWWWWWWWWWWWWWWWWWWWWW
WWWWWW.............WWWWWWWWWWWWWWWWWWWWW
WWWWWW...............WWWWWWWWWWWWWWWWWWW
WWWWWWW................WWWWWWWWWWWWWWWWW
WWWWWWWW.............WWWWWWWWWWWWWWWWWWW
WWWWWWWWW...........WWWWWWWWWWWWWWWWWWWW
WWWWWWW............WWWWWWWWWWWWWWWWWWWWW
WWWWWWWW..........WWWWWWWWWWWWWWWWWWWWWW
WWWWWW.............WWWWWWWWWWWWWWWWWWWWW
WWWWWWW..............WWWWWWWWWWWWWWWWWWW
WWWWWW...............WWWWWWWWWWWWWWWWWWW
WWWW.................WWWWWWWWWWWWWWWWWWW
WW.....................WWWWWWWWWWWWWWWWW
WWWW.....................WWWWWWWWWWWWWWW
WWW.....................WWWWWWWWWWWWWWWW
WW....................WWWWWWWWWWWWWWWWWW
WW....................WWWWWWWWWWWWWWWWWW
WWWW................WWWWWWWWWWWWWWWWWWWW
WWWWW...............WWWWWWWWWWWWWWWWWWWW
WWWWW.................WWWWWWWWWWWWWWWWWW
WWWWWWW..............WWWWWWWWWWWWWWWWWWW
WWWWWWW..............WWWWWWWWWWWWWWWWWWW
WWWWWW...............WWWWWWWWWWWWWWWWWWW
WWWWWWWW............WWWWWWWWWWWWWWWWWWWW
WWWWWWWWW.............WWWWWWWWWWWWWWWWWW
WWWWWWWWWWW.........WWWWWWWWWWWWWWWWWWWW
WWWWWWWWWW...........WWWWWWWWWWWWWWWWWWW
WWWWWWWWWWW............WWWWWWWWWWWWWWWWW
WWWWWWWWWWWW.........WWWWWWWWWWWWWWWWWWW
WWWWWWWWWWWW........WWWWWWWWWWWWWWWWWWWW
WWWWWWWWWWWWW.......WWWWWWWWWWWWWWWWWWWW