DDDDDDDDDDDDDDDDDDDDDDDDDDDDDD
DDDDDDDDDDDDDDDDDDDDDDDDDDDDDD
DDDDDDDDDDDDDDDDDDDDDDDDDDDDDD
DDDDDDDDDDDDDDDDDDDDDDDDDDDDDD
DDDDDDDDDDDDDDDDDDDDDDDDDDDDDD
DDDDDDDDDDDDDDDDDDDDDDDDDDDDDD
DDDDDDDDDDDDDDDDDDDDDDDDDDDDDD
DDDDDDDDDDDDDDDDDDDDDDDDDDDDDD
DDDDDDDDDDDDDDDDDDDDDDDDDDDDDD
DDDDDDDDDDDDDDDDDDDDDDDDDDDDDD
DDDDDDDDDDDDDDDDDDDDDDDDDDDDDD
DDDDDDDDDDDDDDDDDDDDDDDDDDDDDD
DDDDDDDDDDDDDDDDDDDDDDDDDDDDDD
DDDDDDDDDDDDDDDDDDDDDDDDDDDDDD
DDDDDDDDDDDDDDDDDDDDDDDDDDDDDD
DDDDDDDDDDDDDDDDDDDDDDDDDDDDDD
DDDDDDDDDDDDDDDDDDDDDDDDDDDDDD
DDDDDDDDDDDDDDDDDDDDDDDDDDDDDD
DDDDDDDDDDDDDDDDDDDDDDDDDDDDDD
DDDDDDDDDDDDDDDDDDDDDDDDDDDDDD
DDDDDDDDDDDDDDDDDDDDDDDDDDDDDD
DDDDDDDDDDDDDDDDDDDDDDDDDDDDDD
DDDDDDDDDDDDDDDDDDDDDDDDDDDDDD
DDDDDDDDDDDDDDDDDDDDDDDDDDDDDD
DDDDDDDDDDDDDDDDDDDDDDDDDDDDDD
DDDDDDDDDDDDDDDDDDDDDDDDDDDDDD
DDDDDDDDDDDDDDDDDDDDDDDDDDDDDD
DDDDDDDDDDDDDDDDDDDDDDDDDDDDDD
DDDDDDDDDDDDDDDDDDDDDDDDDDDDDD
DDDDDDDDDDDDDDDDDDDDDDDDDDDDDD
---
WWWWWWWWWW.......WWWWWWWWWWWWW
WWWWWWWWWWWW.....WWWWWWWWWWWWW
WWWWWWWWWWWWWW....WWWWWWWWWWWW
WWWWWWWWWWWWWWWW.WWWWWWWWWWWWW
WWWWWWWWWWWWWWW..WWWWWWWWWWWWW
WWWWWWWWWWWWWWWW.WWWWWWWWWWWWW
WWWWWWWWWWWWWW..WWWWWWWWWWWWWW
WWWWWWWWWWWWWW.WWWWWWWWWWWWWWW
WWWWWWWWWWWW.....WWWWWWWWWWWWW
WWWWWWWWWW........WWWWWWWWWWWW
WWWWWWWWWWW........WWWWWWWWWWW
WWWWWWWWWWWWW.......WWWWWWWWWW
WWWWWWWWWWWW.........WWWWWWWWW
WWWWWWWWWWW..........WWWWWWWWW
WWWWWWWWWWW........WWWWWWWWWWW
WWWWWWWWWWWW......WWWWWWWWWWWW
WWWWWWWWWWW.....WWWWWWWWWWWWWW
WWWWWWWWWWWWW.WWWWWWWWWWWWWWWW
WWWWWWWWWWWWWWW.WWWWWWWWWWWWWW
WWWWWWWWWWWWWWW...WWWWWWWWWWWW
WWWWWWWWWWWWWWW.....WWWWWWWWWW
WWWWWWWWWWWWW......WWWWWWWWWWW
WWWWWWWWWWWWW.....WWWWWWWWWWWW
WWWWWWWWWWWWW....WWWWWWWWWWWWW
WWWWWWWWWWW........WWWWWWWWWWW
WWWWWWWWWW.........WWWWWWWWWWW
WWWWWWWW.............WWWWWWWWW
WWWWWWWWW...........WWWWWWWWWW
WWWWWWW...........WWWWWWWWWWWW
WWWWWWWW............WWWWWWWWWW