DDDDDDDDDDDDDDDDDDDDDDDDDDDDDDDDDDDDDDDD
DDDDDDDDDDDDDDDDDDDDDDDDDDDDDDDDDDDDDDDD
DDDDDDDDDDDDDDDDDDDDDDDDDDDDDDDDDDDDDDDD
DDDDDDDDDDDDDDDDDDDDDDDDDDDDDDDDDDDDDDDD
DDDDDDDDDDDDDDDDDDDDDDDDDDDDDDDDDDDDDDDD
DDDDDDDDDDDDDDDDDDDDDDDDDDDDDDDDDDDDDDDD
DDDDDDDDDDDDDDDDDDDDDDDDDDDDDDDDDDDDDDDD
DDDDDDDDDDDDDDDDDDDDDDDDDDDDDDDDDDDDDDDD
DDDDDDDDDDDDDDDDDDDDDDDDDDDDDDDDDDDDDDDD
DDDDDDDDDDDDDDDDDDDDDDDDDDDDDDDDDDDDDDDD
DDDDDDDDDDDDDDDDDDDDDDDDDDDDDDDDDDDDDDDD
DDDDDDDDDDDDDDDDDDDDDDDDDDDDDDDDDDDDDDDD
DDDDDDDDDDDDDDDDDDDDDDDDDDDDDDDDDDDDDDDD
DDDDDDDDDDDDDDDDDDDDDDDDDDDDDDDDDDDDDDDD
DDDDDDDDDDDDDDDDDDDDDDDDDDDDDDDDDDDDDDDD
DDDDDDDDDDDDDDDDDDDDDDDDDDDDDDDDDDDDDDDD
DDDDDDDDDDDDDDDDDDDDDDDDDDDDDDDDDDDDDDDD
DDDDDDDDDDDDDDDDDDDDDDDDDDDDDDDDDDDDDDDD
DDDDDDDDDDDDDDDDDDDDDDDDDDDDDDDDDDDDDDDD
DDDDDDDDDDDDDDDDDDDDDDDDDDDDDDDDDDDDDDDD
DDDDDDDDDDDDDDDDDDDDDDDDDDDDDDDDDDDDDDDD
DDDDDDDDDDDDDDDDDDDDDDDDDDDDDDDDDDDDDDDD
DDDDDDDDDDDDDDDDDDDDDDDDDDDDDDDDDDDDDDDD
DDDDDDDDDDDDDDDDDDDDDDDDDDDDDDDDDDDDDDDD
DDDDDDDDDDDDDDDDDDDDDDDDDDDDDDDDDDDDDDDD
DDDDDDDDDDDDDDDDDDDDDDDDDDDDDDDDDDDDDDDD
DDDDDDDDDDDDDDDDDDDDDDDDDDDDDDDDDDDDDDDD
DDDDDDDDDDDDDDDDDDDDDDDDDDDDDDDDDDDDDDDD
DDDDDDDDDDDDDDDDDDDDDDDDDDDDDDDDDDDDDDDD
DDDDDDDDDDDDDDDDDDDDDDDDDDDDDDDDDDDDDDDD
DDDDDDDDDDDDDDDDDDDDDDDDDDDDDDDDDDDDDDDD
DDDDDDDDDDDDDDDDDDDDDDDDDDDDDDDDDDDDDDDD
DDDDDDDDDDDDDDDDDDDDDDDDDDDDDDDDDDDDDDDD
DDDDDDDDDDDDDDDDDDDDDDDDDDDDDDDDDDDDDDDD
DDDDDDDDDDDDDDDDDDDDDDDDDDDDDDDDDDDDDDDD
DDDDDDDDDDDDDDDDDDDDDDDDDDDDDDDDDDDDDDDD
DDDDDDDDDDDDDDDDDDDDDDDDDDDDDDDDDDDDDDDD
DDDDDDDDDDDDDDDDDDDDDDDDDDDDDDDDDDDDDDDD
DDDDDDDDDDDDDDDDDDDDDDDDDDDDDDDDDDDDDDDD
DDDDDDDDDDDDDDDDDDDDDDDDDDDDDDDDDDDDDDDD
---
WWWWWWWWWWWWWWW.........WWWWWWWWWWWWWWWW
WWWWWWWWWWWWWW............WWWWWWWWWWWWWW
WWWWWWWWWWWWW..............WWWWWWWWWWWWW
WWWWWWWWWWWWWWW............WWWWWWWWWWWWW
WWWWWWWWWWWWW...............WWWWWWWWWWWW
WWWWWWWWWWWWWWW...........WWWWWWWWWWWWWW
WWWWWWWWWWWWWWWW............WWWWWWWWWWWW
WWWWWWWWWWWWWW................WWWWWWWWWW
WWWWWWWWWWWWW................WWWWWWWWWWW
WWWWWWWWWWWW.................WWWWWWWWWWW
WWWWWWWWWWWWWW.................WWWWWWWWW
WWWWWWWWWWWWWWW...............WWWWWWWWWW
WWWWWWWWWWWWWWW.................WWWWWWWW
WWWWWWWWWWWWWWW................WWWWWWWWW
WWWWWWWWWWWWWW..................WWWWWWWW
WWWWWWWWWWWWWW....................WWWWWW
WWWWWWWWWWWW........................WWWW
WWWWWWWWWW..........................WWWW
WWWWWWWWWW........................WWWWWW
WWWWWWWWWWW.........................WWWW
WWWWWWWWW.............................WW
WWWWWWWW..............................WW
WWWWWWWW.............................WWW
WWWWWWWWW.............................WW
WWWWWWWWWWW.........................WWWW
WWWWWWWWW...........................WWWW
WWWWWWWW...........................WWWWW
WWWWWWWWW...........................WWWW
WWWWWWWWWW........................WWWWWW
WWWWWWWW...........................WWWWW
WWWWWWW............................WWWWW
WWWWWWWWW........................WWWWWWW
WWWWWWWWWWW.......................WWWWWW
WWWWWWWWWWWWW.......................WWWW
WWWWWWWWWWWWWWW......................WWW
WWWWWWWWWWWWWWW.......................WW
WWWWWWWWWWWWWWWW.....................WWW
WWWWWWWWWWWWWWWWWW....................WW
WWWWWWWWWWWWWWWW......................WW
WWWWWWWWWWWWWW........................WW