DDDDDDDDDDDDDDDDDDDDDDDDDDDDDDDDDDDDDDDDDDDDDDDDDDDDDDDDDDDDDDDDDDDDDD
DDDDDDDDDDDDDDDDDDDDDDDDDDDDDDDDDDDDDDDDDDDDDDDDDDDDDDDDDDDDDDDDDDDDDD
DDDDDDDDDDDDDDDDDDDDDDDDDDDDDDDDDDDDDDDDDDDDDDDDDDDDDDDDDDDDDDDDDDDDDD
DDDDDDDDDDDDDDDDDDDDDDDDDDDDDDDDDDDDDDDDDDDDDDDDDDDDDDDDDDDDDDDDDDDDDD
DDDDDDDDDDDDDDDDDDDDDDDDDDDDDDDDDDDDDDDDDDDDDDDDDDDDDDDDDDDDDDDDDDDDDD
DDDDDDDDDDDDDDDDDDDDDDDDDDDDDDDDDDDDDDDDDDDDDDDDDDDDDDDDDDDDDDDDDDDDDD
DDDDDDDDDDDDDDDDDDDDDDDDDDDDDDDDDDDDDDDDDDDDDDDDDDDDDDDDDDDDDDDDDDDDDD
DDDDDDDDDDDDDDDDDDDDDDDDDDDDDDDDDDDDDDDDDDDDDDDDDDDDDDDDDDDDDDDDDDDDDD
DDDDDDDDDDDDDDDDDDDDDDDDDDDDDDDDDDDDDDDDDDDDDDDDDDDDDDDDDDDDDDDDDDDDDD
DDDDDDDDDDDDDDDDDDDDDDDDDDDDDDDDDDDDDDDDDDDDDDDDDDDDDDDDDDDDDDDDDDDDDD
DDDDDDDDDDDDDDDDDDDDDDDDDDDDDDDDDDDDDDDDDDDDDDDDDDDDDDDDDDDDDDDDDDDDDD
DDDDDDDDDDDDDDDDDDDDDDDDDDDDDDDDDDDDDDDDDDDDDDDDDDDDDDDDDDDDDDDDDDDDDD
DDDDDDDDDDDDDDDDDDDDDDDDDDDDDDDDDDDDDDDDDDDDDDDDDDDDDDDDDDDDDDDDDDDDDD
DDDDDDDDDDDDDDDDDDDDDDDDDDDDDDDDDDDDDDDDDDDDDDDDDDDDDDDDDDDDDDDDDDDDDD
DDDDDDDDDDDDDDDDDDDDDDDDDDDDDDDDDDDDDDDDDDDDDDDDDDDDDDDDDDDDDDDDDDDDDD
DDDDDDDDDDDDDDDDDDDDDDDDDDDDDDDDDDDDDDDDDDDDDDDDDDDDDDDDDDDDDDDDDDDDDD
DDDDDDDDDDDDDDDDDDDDDDDDDDDDDDDDDDDDDDDDDDDDDDDDDDDDDDDDDDDDDDDDDDDDDD
DDDDDDDDDDDDDDDDDDDDDDDDDDDDDDDDDDDDDDDDDDDDDDDDDDDDDDDDDDDDDDDDDDDDDD
DDDDDDDDDDDDDDDDDDDDDDDDDDDDDDDDDDDDDDDDDDDDDDDDDDDDDDDDDDDDDDDDDDDDDD
DDDDDDDDDDDDDDDDDDDDDDDDDDDDDDDDDDDDDDDDDDDDDDDDDDDDDDDDDDDDDDDDDDDDDD
DDDDDDDDDDDDDDDDDDDDDDDDDDDDDDDDDDDDDDDDDDDDDDDDDDDDDDDDDDDDDDDDDDDDDD
DDDDDDDDDDDDDDDDDDDDDDDDDDDDDDDDDDDDDDDDDDDDDDDDDDDDDDDDDDDDDDDDDDDDDD
DDDDDDDDDDDDDDDDDDDDDDDDDDDDDDDDDDDDDDDDDDDDDDDDDDDDDDDDDDDDDDDDDDDDDD
DDDDDDDDDDDDDDDDDDDDDDDDDDDDDDDDDDDDDDDDDDDDDDDDDDDDDDDDDDDDDDDDDDDDDD
DDDDDDDDDDDDDDDDDDDDDDDDDDDDDDDDDDDDDDDDDDDDDDDDDDDDDDDDDDDDDDDDDDDDDD
DDDDDDDDDDDDDDDDDDDDDDDDDDDDDDDDDDDDDDDDDDDDDDDDDDDDDDDDDDDDDDDDDDDDDD
DDDDDDDDDDDDDDDDDDDDDDDDDDDDDDDDDDDDDDDDDDDDDDDDDDDDDDDDDDDDDDDDDDDDDD
DDDDDDDDDDDDDDDDDDDDDDDDDDDDDDDDDDDDDDDDDDDDDDDDDDDDDDDDDDDDDDDDDDDDDD
DDDDDDDDDDDDDDDDDDDDDDDDDDDDDDDDDDDDDDDDDDDDDDDDDDDDDDDDDDDDDDDDDDDDDD
DDDDDDDDDDDDDDDDDDDDDDDDDDDDDDDDDDDDDDDDDDDDDDDDDDDDDDDDDDDDDDDDDDDDDD
DDDDDDDDDDDDDDDDDDDDDDDDDDDDDDDDDDDDDDDDDDDDDDDDDDDDDDDDDDDDDDDDDDDDDD
DDDDDDDDDDDDDDDDDDDDDDDDDDDDDDDDDDDDDDDDDDDDDDDDDDDDDDDDDDDDDDDDDDDDDD
DDDDDDDDDDDDDDDDDDDDDDDDDDDDDDDDDDDDDDDDDDDDDDDDDDDDDDDDDDDDDDDDDDDDDD
DDDDDDDDDDDDDDDDDDDDDDDDDDDDDDDDDDDDDDDDDDDDDDDDDDDDDDDDDDDDDDDDDDDDDD
DDDDDDDDDDDDDDDDDDDDDDDDDDDDDDDDDDDDDDDDDDDDDDDDDDDDDDDDDDDDDDDDDDDDDD
DDDDDDDDDDDDDDDDDDDDDDDDDDDDDDDDDDDDDDDDDDDDDDDDDDDDDDDDDDDDDDDDDDDDDD
DDDDDDDDDDDDDDDDDDDDDDDDDDDDDDDDDDDDDDDDDDDDDDDDDDDDDDDDDDDDDDDDDDDDDD
DDDDDDDDDDDDDDDDDDDDDDDDDDDDDDDDDDDDDDDDDDDDDDDDDDDDDDDDDDDDDDDDDDDDDD
DDDDDDDDDDDDDDDDDDDDDDDDDDDDDDDDDDDDDDDDDDDDDDDDDDDDDDDDDDDDDDDDDDDDDD
DDDDDDDDDDDDDDDDDDDDDDDDDDDDDDDDDDDDDDDDDDDDDDDDDDDDDDDDDDDDDDDDDDDDDD
DDDDDDDDDDDDDDDDDDDDDDDDDDDDDDDDDDDDDDDDDDDDDDDDDDDDDDDDDDDDDDDDDDDDDD
DDDDDDDDDDDDDDDDDDDDDDDDDDDDDDDDDDDDDDDDDDDDDDDDDDDDDDDDDDDDDDDDDDDDDD
DDDDDDDDDDDDDDDDDDDDDDDDDDDDDDDDDDDDDDDDDDDDDDDDDDDDDDDDDDDDDDDDDDDDDD
DDDDDDDDDDDDDDDDDDDDDDDDDDDDDDDDDDDDDDDDDDDDDDDDDDDDDDDDDDDDDDDDDDDDDD
DDDDDDDDDDDDDDDDDDDDDDDDDDDDDDDDDDDDDDDDDDDDDDDDDDDDDDDDDDDDDDDDDDDDDD
DDDDDDDDDDDDDDDDDDDDDDDDDDDDDDDDDDDDDDDDDDDDDDDDDDDDDDDDDDDDDDDDDDDDDD
DDDDDDDDDDDDDDDDDDDDDDDDDDDDDDDDDDDDDDDDDDDDDDDDDDDDDDDDDDDDDDDDDDDDDD
DDDDDDDDDDDDDDDDDDDDDDDDDDDDDDDDDDDDDDDDDDDDDDDDDDDDDDDDDDDDDDDDDDDDDD
DDDDDDDDDDDDDDDDDDDDDDDDDDDDDDDDDDDDDDDDDDDDDDDDDDDDDDDDDDDDDDDDDDDDDD
DDDDDDDDDDDDDDDDDDDDDDDDDDDDDDDDDDDDDDDDDDDDDDDDDDDDDDDDDDDDDDDDDDDDDD
DDDDDDDDDDDDDDDDDDDDDDDDDDDDDDDDDDDDDDDDDDDDDDDDDDDDDDDDDDDDDDDDDDDDDD
DDDDDDDDDDDDDDDDDDDDDDDDDDDDDDDDDDDDDDDDDDDDDDDDDDDDDDDDDDDDDDDDDDDDDD
DDDDDDDDDDDDDDDDDDDDDDDDDDDDDDDDDDDDDDDDDDDDDDDDDDDDDDDDDDDDDDDDDDDDDD
DDDDDDDDDDDDDDDDDDDDDDDDDDDDDDDDDDDDDDDDDDDDDDDDDDDDDDDDDDDDDDDDDDDDDD
DDDDDDDDDDDDDDDDDDDDDDDDDDDDDDDDDDDDDDDDDDDDDDDDDDDDDDDDDDDDDDDDDDDDDD
DDDDDDDDDDDDDDDDDDDDDDDDDDDDDDDDDDDDDDDDDDDDDDDDDDDDDDDDDDDDDDDDDDDDDD
DDDDDDDDDDDDDDDDDDDDDDDDDDDDDDDDDDDDDDDDDDDDDDDDDDDDDDDDDDDDDDDDDDDDDD
DDDDDDDDDDDDDDDDDDDDDDDDDDDDDDDDDDDDDDDDDDDDDDDDDDDDDDDDDDDDDDDDDDDDDD
DDDDDDDDDDDDDDDDDDDDDDDDDDDDDDDDDDDDDDDDDDDDDDDDDDDDDDDDDDDDDDDDDDDDDD
DDDDDDDDDDDDDDDDDDDDDDDDDDDDDDDDDDDDDDDDDDDDDDDDDDDDDDDDDDDDDDDDDDDDDD
DDDDDDDDDDDDDDDDDDDDDDDDDDDDDDDDDDDDDDDDDDDDDDDDDDDDDDDDDDDDDDDDDDDDDD
DDDDDDDDDDDDDDDDDDDDDDDDDDDDDDDDDDDDDDDDDDDDDDDDDDDDDDDDDDDDDDDDDDDDDD
DDDDDDDDDDDDDDDDDDDDDDDDDDDDDDDDDDDDDDDDDDDDDDDDDDDDDDDDDDDDDDDDDDDDDD
DDDDDDDDDDDDDDDDDDDDDDDDDDDDDDDDDDDDDDDDDDDDDDDDDDDDDDDDDDDDDDDDDDDDDD
DDDDDDDDDDDDDDDDDDDDDDDDDDDDDDDDDDDDDDDDDDDDDDDDDDDDDDDDDDDDDDDDDDDDDD
DDDDDDDDDDDDDDDDDDDDDDDDDDDDDDDDDDDDDDDDDDDDDDDDDDDDDDDDDDDDDDDDDDDDDD
DDDDDDDDDDDDDDDDDDDDDDDDDDDDDDDDDDDDDDDDDDDDDDDDDDDDDDDDDDDDDDDDDDDDDD
DDDDDDDDDDDDDDDDDDDDDDDDDDDDDDDDDDDDDDDDDDDDDDDDDDDDDDDDDDDDDDDDDDDDDD
DDDDDDDDDDDDDDDDDDDDDDDDDDDDDDDDDDDDDDDDDDDDDDDDDDDDDDDDDDDDDDDDDDDDDD
DDDDDDDDDDDDDDDDDDDDDDDDDDDDDDDDDDDDDDDDDDDDDDDDDDDDDDDDDDDDDDDDDDDDDD
---
WWWWWWWWWWWWWWWWWWWWWWWWWWWWWWWWWWW...............WWWWWWWWWWWWWWWWWWWW
WWWWWWWWWWWWWWWWWWWWWWWWWWWWWWWWWW..................WWWWWWWWWWWWWWWWWW
WWWWWWWWWWWWWWWWWWWWWWWWWWWWWWWWWWWW..................WWWWWWWWWWWWWWWW
WWWWWWWWWWWWWWWWWWWWWWWWWWWWWWWWWW......................WWWWWWWWWWWWWW
WWWWWWWWWWWWWWWWWWWWWWWWWWWWWWWWW.........................WWWWWWWWWWWW
WWWWWWWWWWWWWWWWWWWWWWWWWWWWWWW.............................WWWWWWWWWW
WWWWWWWWWWWWWWWWWWWWWWWWWWWWWWWW............................WWWWWWWWWW
WWWWWWWWWWWWWWWWWWWWWWWWWWWWWWWWW............................WWWWWWWWW
WWWWWWWWWWWWWWWWWWWWWWWWWWWWWWWWW..............................WWWWWWW
WWWWWWWWWWWWWWWWWWWWWWWWWWWWWWWWWWW............................WWWWWWW
WWWWWWWWWWWWWWWWWWWWWWWWWWWWWWWWWWW.............................WWWWWW
WWWWWWWWWWWWWWWWWWWWWWWWWWWWWWWWWWWW...........................WWWWWWW
WWWWWWWWWWWWWWWWWWWWWWWWWWWWWWWWWW...............................WWWWW
WWWWWWWWWWWWWWWWWWWWWWWWWWWWWWWWWWWW.............................WWWWW
WWWWWWWWWWWWWWWWWWWWWWWWWWWWWWWWWWWW.............................WWWWW
WWWWWWWWWWWWWWWWWWWWWWWWWWWWWWWWWW..............................WWWWWW
WWWWWWWWWWWWWWWWWWWWWWWWWWWWWWWWW..............................WWWWWWW
WWWWWWWWWWWWWWWWWWWWWWWWWWWWWWWWWW..............................WWWWWW
WWWWWWWWWWWWWWWWWWWWWWWWWWWWWWWWW.................................WWWW
WWWWWWWWWWWWWWWWWWWWWWWWWWWWWWWWW.................................WWWW
WWWWWWWWWWWWWWWWWWWWWWWWWWWWWWWWWW................................WWWW
WWWWWWWWWWWWWWWWWWWWWWWWWWWWWWWWWWWW..............................WWWW
WWWWWWWWWWWWWWWWWWWWWWWWWWWWWWWWWWW...............................WWWW
WWWWWWWWWWWWWWWWWWWWWWWWWWWWWWWWWWWWW...............................WW
WWWWWWWWWWWWWWWWWWWWWWWWWWWWWWWWWWWWWWW.............................WW
WWWWWWWWWWWWWWWWWWWWWWWWWWWWWWWWWWWWWWWWW...........................WW
WWWWWWWWWWWWWWWWWWWWWWWWWWWWWWWWWWWWWWW.............................WW
WWWWWWWWWWWWWWWWWWWWWWWWWWWWWWWWWWWWWW............................WWWW
WWWWWWWWWWWWWWWWWWWWWWWWWWWWWWWWWWWWWWW..........................WWWWW
WWWWWWWWWWWWWWWWWWWWWWWWWWWWWWWWWWWWWW.............................WWW
WWWWWWWWWWWWWWWWWWWWWWWWWWWWWWWWWWWWW...............................WW
WWWWWWWWWWWWWWWWWWWWWWWWWWWWWWWWWWWWW...............................WW
WWWWWWWWWWWWWWWWWWWWWWWWWWWWWWWWWWWW................................WW
WWWWWWWWWWWWWWWWWWWWWWWWWWWWWWWWWWW.................................WW
WWWWWWWWWWWWWWWWWWWWWWWWWWWWWWWWWWWWW...............................WW
WWWWWWWWWWWWWWWWWWWWWWWWWWWWWWWWWWWW................................WW
WWWWWWWWWWWWWWWWWWWWWWWWWWWWWWWWWWW.................................WW
WWWWWWWWWWWWWWWWWWWWWWWWWWWWWWWWW.................................WWWW
WWWWWWWWWWWWWWWWWWWWWWWWWWWWWWWWWW...............................WWWWW
WWWWWWWWWWWWWWWWWWWWWWWWWWWWWWWW...............................WWWWWWW
WWWWWWWWWWWWWWWWWWWWWWWWWWWWWWWW..............................WWWWWWWW
WWWWWWWWWWWWWWWWWWWWWWWWWWWWWW..................................WWWWWW
WWWWWWWWWWWWWWWWWWWWWWWWWWWWWW.................................WWWWWWW
WWWWWWWWWWWWWWWWWWWWWWWWWWWWWWW................................WWWWWWW
WWWWWWWWWWWWWWWWWWWWWWWWWWWWW.................................WWWWWWWW
WWWWWWWWWWWWWWWWWWWWWWWWWWWW................................WWWWWWWWWW
WWWWWWWWWWWWWWWWWWWWWWWWWWWWWW............................WWWWWWWWWWWW
WWWWWWWWWWWWWWWWWWWWWWWWWWWWW...............................WWWWWWWWWW
WWWWWWWWWWWWWWWWWWWWWWWWWWWWW.................................WWWWWWWW
WWWWWWWWWWWWWWWWWWWWWWWWWWWWW.................................WWWWWWWW
WWWWWWWWWWWWWWWWWWWWWWWWWWWWW...................................WWWWWW
WWWWWWWWWWWWWWWWWWWWWWWWWWWWWWW..................................WWWWW
WWWWWWWWWWWWWWWWWWWWWWWWWWWWWWWWW..............................WWWWWWW
WWWWWWWWWWWWWWWWWWWWWWWWWWWWWWWWW................................WWWWW
WWWWWWWWWWWWWWWWWWWWWWWWWWWWWWWWWW...............................WWWWW
WWWWWWWWWWWWWWWWWWWWWWWWWWWWWWWWW................................WWWWW
WWWWWWWWWWWWWWWWWWWWWWWWWWWWWWWWWW................................WWWW
WWWWWWWWWWWWWWWWWWWWWWWWWWWWWWWWWWW..............................WWWWW
WWWWWWWWWWWWWWWWWWWWWWWWWWWWWWWWWW................................WWWW
WWWWWWWWWWWWWWWWWWWWWWWWWWWWWWWWWWW..............................WWWWW
WWWWWWWWWWWWWWWWWWWWWWWWWWWWWWWWWW..............................WWWWWW
WWWWWWWWWWWWWWWWWWWWWWWWWWWWWWWWWWW..............................WWWWW
WWWWWWWWWWWWWWWWWWWWWWWWWWWWWWWWWWWW............................WWWWWW
WWWWWWWWWWWWWWWWWWWWWWWWWWWWWWWWWW...............................WWWWW
WWWWWWWWWWWWWWWWWWWWWWWWWWWWWWWW...............................WWWWWWW
WWWWWWWWWWWWWWWWWWWWWWWWWWWWWWWW.................................WWWWW
WWWWWWWWWWWWWWWWWWWWWWWWWWWWWWWWW..................................WWW
WWWWWWWWWWWWWWWWWWWWWWWWWWWWWWWW..................................WWWW
WWWWWWWWWWWWWWWWWWWWWWWWWWWWWW..................................WWWWWW
WWWWWWWWWWWWWWWWWWWWWWWWWWWW......................................WWWW