DDDDDDDDDDDDDDDDDDDDDDDDDDDDDDDDDDDDDDDDDDDDDDDDDD
DDDDDDDDDDDDDDDDDDDDDDDDDDDDDDDDDDDDDDDDDDDDDDDDDD
DDDDDDDDDDDDDDDDDDDDDDDDDDDDDDDDDDDDDDDDDDDDDDDDDD
DDDDDDDDDDDDDDDDDDDDDDDDDDDDDDDDDDDDDDDDDDDDDDDDDD
DDDDDDDDDDDDDDDDDDDDDDDDDDDDDDDDDDDDDDDDDDDDDDDDDD
DDDDDDDDDDDDDDDDDDDDDDDDDDDDDDDDDDDDDDDDDDDDDDDDDD
DDDDDDDDDDDDDDDDDDDDDDDDDDDDDDDDDDDDDDDDDDDDDDDDDD
DDDDDDDDDDDDDDDDDDDDDDDDDDDDDDDDDDDDDDDDDDDDDDDDDD
DDDDDDDDDDDDDDDDDDDDDDDDDDDDDDDDDDDDDDDDDDDDDDDDDD
DDDDDDDDDDDDDDDDDDDDDDDDDDDDDDDDDDDDDDDDDDDDDDDDDD
DDDDDDDDDDDDDDDDDDDDDDDDDDDDDDDDDDDDDDDDDDDDDDDDDD
DDDDDDDDDDDDDDDDDDDDDDDDDDDDDDDDDDDDDDDDDDDDDDDDDD
DDDDDDDDDDDDDDDDDDDDDDDDDDDDDDDDDDDDDDDDDDDDDDDDDD
DDDDDDDDDDDDDDDDDDDDDDDDDDDDDDDDDDDDDDDDDDDDDDDDDD
DDDDDDDDDDDDDDDDDDDDDDDDDDDDDDDDDDDDDDDDDDDDDDDDDD
DDDDDDDDDDDDDDDDDDDDDDDDDDDDDDDDDDDDDDDDDDDDDDDDDD
DDDDDDDDDDDDDDDDDDDDDDDDDDDDDDDDDDDDDDDDDDDDDDDDDQ
DDDDDDDDDDDDDDDDDDDDDDDDDDDDDDDDDDDDDDDDDDDDDDDDQQ
DDDDDDDDDDDDDDDDDDDDDDDDDDDDDDDDDDDDDDDDDDDDDDDQQQ
DDDDDDDDDDDDDDDDDDDDDDDDDDDDDDDDSDDDDDDDDDDDDDQQWW
DDDDDDDDDDDDDDDDDDDDDDDDDDDDDDBDSDDDDDDDDDDDDQQQWW
DDDDDDDDDDDDDDDDDDDDDDDDDDDDDDBDSDDDDDDDDDDDQQWWWW
DDDDDDDDDDDDDDDDDDDDDDDDDDDDDSBSSSSSSDDDDDQQQWWWWW
DDDDDDDDDDDDDDDDDDDDDDDDDDDDDDBDSDDDDDDDDDQQWWWWWW
DDDDDDDDDDDDDDDDDDDDDDBDDDDDDDBDSDDDDDDDDQQQWWWWWW
DDDDDDDDDDDDDDDDDDDDDDBDDDDDDDBBBBDDDDDDDDDQQWWWWW
DDDDDDDDDDDDDDDDDDDDDDBDDDDDDDDDDDDDDDDDDDDDQQQWWW
DDDDDDDDDDDDDDDDDDDDDDBDDDDDDDDDDDDDDDDDDDDDDQQQQW
DDDDDDDDDDDDDDDDDDBBBBBBBDDDDDDDDDDDDDDDDDDDDDQQQQ
DDDDDDDDDDDDDDDDBBDDDDDDDBDDDDDDDDDDDDDDDDDDDDDDQQ
DDDDDDDDDDDDDDBBDDDDDDDDDDBDDDDDDDDDDDDDDDDDDDDDDQ
DDDDDDDDDDDDDDDDDDDDDDDDDDBDDDDDDDDDDDDDDDDDDDDDDD
DDDDDDDDDDDDDDDDDDDDDDDDDDBDDDDDDDDDDDDDDDDDDDDDDD
DDDDDDDDDDDDDDDDDDDDDDDDDDDDDDDDDDDDDDDDDDDDDDDDDD
DDDDDDDDDDDDDDDDDDDDDDDDDDDDDDDDDDDDDDDDDDDDDDDDDD
DDDDDDDDDDDDDDDDDDDDDDDDDDDDDDDDDDDDDDDDDDDDDDDDDD
DDDDDDDDDDDDDDDDDDDDDDDDDDDDDDDDDDDDDDDDDDDDDDDDDD
DDDDDDDDDDDDDDDDDDDDDDDDDDDDDDDDDDDDDDDDDDDDDDDDDD
DDDDDDDDDDDDDDDDDDDDDDDDDDDDDDDDDDDDDDDDDDDDDDDDDD
DDDDDDDDDDDDDDDDDDDDDDDDDDDDDDDDDDDDDDDDDDDDDDDDDD
DDDDDDDDDDDDDDDDDDDDDDDDDDDDDDDDDDDDDDDDDDDDDDDDDD
DDDDDDDDDDDDDDDDDDDDDDDDDDDDDDDDDDDDDDDDDDDDDDDDDD
DDDDDDDDDDDDDDDDDDDDDDDDDDDDDDDDDDDDDDDDDDDDDDDDDD
DDDDDDDDDDDDDDDDDDDDDDDDDDDDDDDDDDDDDDDDDDDDDDDDDD
DDDDDDDDDDDDDDDDDDDDDDDDDDDDDDDDDDDDDDDDDDDDDDDDDD
DDDDDDDDDDDDDDDDDDDDDDDDDDDDDDDDDDDDDDDDDDDDDDDDDD
DDDDDDDDDDDDDDDDDDDDDDDDDDDDDDDDDDDDDDDDDDDDDDDDDD
DDDDDDDDDDDDDDDDDDDDDDDDDDDDDDDDDDDDDDDDDDDDDDDDDD
DDDDDDDDDDDDDDDDDDDDDDDDDDDDDDDDDDDDDDDDDDDDDDDDDD
DDDDDDDDDDDDDDDDDDDDDDDDDDDDDDDDDDDDDDDDDDDDDDDDDD
---
...........................................WWWWWWW
...........................................WWWWWWW
............................................WWWWWW
..........................................WWWWWWWW
...........................................WWWWWWW
...........................................WWWWWWW
...........................................WWWWWWW
.............................................WWWWW
..............................................WWWW
...............................................WWW
.............................................WWWWW
..............................................WWWW
..............................................WWWW
............................................WWWWWW
.............................................WWWWW
...............................................WWW
...............................................WWW
.............................................WWWWW
..............................................WWWW
...............................................WWW
.............................................WWWWW
...............................................WWW
...............................................WWW
...............................................WWW
..............................................WWWW
...............................................WWW
..............................................WWWW
...............................................WWW
...............................................WWW
...............................................WWW
...............................................WWW
.............................................WWWWW
..............................................WWWW
...............................................WWW
.............................................WWWWW
...............................................WWW
..............................................WWWW
..............................................WWWW
...............................................WWW
.............................................WWWWW
............................................WWWWWW
..............................................WWWW
...............................................WWW
.............................................WWWWW
..............................................WWWW
..............................................WWWW
............................................WWWWWW
.............................................WWWWW
............................................WWWWWW
............................................WWWWWW