DDDDDDDDDDDD
D..........D
D....BB....D
D....BB....D
D..........D
DDDDDDDDDDDD
---
WWWWWWWWWWWW
W..........W
W.S......S.W
W.S......S.W
W..........W
WWWWWWWWWWWW