WWWWWWWWWQQQQQQQQQQQQQQQQQQQQQQQQQQDDDDDDDDDDDDDDDDDDDDDDDDDDDDDDDDDDD
WWWWWWWWWWWQQQQQQQQQQQQQQQQQQQQQQQQQDDDDDDDDDDDDDDDDDDDDDDDDDDDDDDDDDD
WWWWWWWWWWWWQQQQQQQQQQQQQQQQQQQQQQQQDDDDDDDDDDDDDDDDDDDDDDDDDDDDDDDDDD
WWWWWWWWWWWWWQQQQQQQQQQQQQQQQQQQQQQQQDDDDDDDDDDDDDDDDDDDDDDDDDDDDDDDDD
WWWWWWWWWWWWWWQQQQQQQQQQQQQQQQQQQQQQQDDDDDDDDDDDDDDDDDDDDDDDDDDDDDDDDD
WWWWWWWWWWWWWWWQQQQQQQQQQQQQQQQQQQQQQQDDDDDDDDDDDDDDDDDDDDDDDDDDDDDDDD
WWWWWWWWWWWWWWWWQQQQQQQQQQQQQQQQQQQQQQDDDDDDDDDDDDDDDDDDDDDDDDDDDDDDDD
WWWWWWWWWWWWWWWWQQQQQQQQQQQQQQQQQQQQQQDDDDDDDDDDDDDDDDDDDDDDDDDDDDDDDD
WWWWWWWWWWWWWWWWWQQQQQQQQQQQQQQQQQQQQQQDDDDDDDDDDDDDDDDDDDDDDDDDDDDDDD
WWWWWWWWWWWWWWWWWWQQQQQQQQQQQQQQQQQQQQQDDDDDDDDDDDDDDDDDDDDDDDDDDDDDDD
WWWWWWWWWWWWWWWWWWQQQQQQQQQQQQQQQQQQQQQQDDDDDDDDDDDDDDDDDDDDDDDDDDDDDD
WWWWWWWWWWWWWWWWWWWQQQQQQQQQQQQQQQQQQQQQDDDDDDDDDDDDDDDDDDDDDDDDDDDDDD
WWWWWWWWWWWWWWWWWWWQQQQQQQQQQQQQQQQQQQQQDDDDDDDDDDDDDDDDDDDDDDDDDDDDDD
WWWWWWWWWWWWWWWWWWWQQQQQQQQQQQQQQQQQQQQQDDDDDDDDDDDDDDDDDDDDDDDDDDDDDD
WWWWWWWWWWWWWWWWWWWWQQQQQQQQQQQQQQQQQQQQQDDDDDDDDDDDDDDDDDDDDDDDDDDDDD
WWWWWWWWWWWWWWWWWWWWQQQQQQQQQQQQQQQQQQQQQDDDDDDDDDDDDDDDDDDDDDDDDDDDDD
WWWWWWWWWWWWWWWWWWWWQQQQQQQQQQQQQQQQQQQQQDDDDDDDDDDDDDDDDDDDDDDDDDDDDD
WWWWWWWWWWWWWWWWWWWWQQQQQQQQQQQQQQQQQQQQQDDDDDDDDDDDDDDDDDDDDDDDDDDDDD
WWWWWWWWWWWWWWWWWWWWQQQQQQQQQQQQQQQQQQQQQDDDDDDDDDDDDDDDDDDDDDDDDDDDDD
WWWWWWWWWWWWWWWWWWWWQQQQQQQQQQQQQQQQQQQQQDDDDDDDDDDDDDDDDDDDDDDDDDDDDD
WWWWWWWWWWWWWWWWWWWWQQQQQQQQQQQQQQQQQQQQQDDDDDDDDDDDDDDDDDDDDDDDDDDDDQ
WWWWWWWWWWWWWWWWWWWWQQQQQQQQQQQQQQQQQQQQQQDDDDDDDDDDDDDDDDDDDDDDDDDDQQ
WWWWWWWWWWWWWWWWWWWWQQQQQQQQQQQQQQQQQQQQQQDDDDDDDDDDDDDDDDDDDDDDDDDQQQ
WWWWWWWWWWWWWWWWWWWWQQQQQQQQQQQQQQQQQQQQQQDDDDDDDDDDDDDDDDDDDDDDDDQQQQ
WWWWWWWWWWWWWWWWWWWWQQQQQQQQQQQQQQQQQQQQQQDDDDDDDDDDDDDDDDDDDDDDDQQQQQ
WWWWWWWWWWWWWWWWWWWWQQQQQQQQQQQQQQQQQQQQQQDDDDDDDDDDDDDDDDDDDDDDQQQQQQ
WWWWWWWWWWWWWWWWWWWWQQQQQQQQQQQQQQQQQQQQQQDDDDDDDDDDDDDDDDDDDDDQQQQQQQ
WWWWWWWWWWWWWWWWWWWWQQQQQQQQQQQQQQQQQQQQQQDDDDDDDDDDDDDDDDDDDDQQQQQQQQ
WWWWWWWWWWWWWWWWWWWWQQQQQQQQQQQQQQQQQQQQQQDDDDDDDDDDDDDDDDDDDQQQQQQQQQ
WWWWWWWWWWWWWWWWWWWQQQQQQQQQQQQQQQQQQQQQQQDDDDDDDDDDDDDDDDDDQQQQQQQQQQ
WWWWWWWWWWWWWWWWWWWQQQQQQQQQQQQQQQQQQQQQQQDDDDDDDDDDDDDDDDDDQQQQQQQQQQ
WWWWWWWWWWWWWWWWWWWQQQQQQQQQQQQQQQQQQQQQQQDDDDDDDDDDDDDDDDDQQQQQQQQQQQ
WWWWWWWWWWWWWWWWWWQQQQQQQQQQQQQQQQQQQQQQQDDDDDDDDDDDDDDDDDQQQQQQQQQQQQ
WWWWWWWWWWWWWWWWWWQQQQQQQQQQQQQQQQQQQQQQQDDDDDDDDDDDDDDDDQQQQQQQQQQQQQ
WWWWWWWWWWWWWWWWWQQQQQQQQQQQQQQQQQQQQQQQQDDDDDDDDDDDDDDDDQQQQQQQQQQQQQ
WWWWWWWWWWWWWWWWWQQQQQQQQQQQQQQQQQQQQQQQQDDDDDDDDDDDDDDDQQQQQQQQQQQQQQ
WWWWWWWWWWWWWWWWQQQQQQQQQQQQQQQQQQQQQQQQDDDDDDDDDDDDDDDQQQQQQQQQQQQQQQ
WWWWWWWWWWWWWWWQQQQQQQQQQQQQQQQQQQQQQQQQDDDDDDDDDDDDDDDQQQQQQQQQQQQQQQ
WWWWWWWWWWWWWWQQQQQQQQQQQQQQQQQQQQQQQQQDDDDDDDDDDDDDDDQQQQQQQQQQQQQQQQ
WWWWWWWWWWWWWQQQQQQQQQQQQQQQQQQQQQQQQQQDDDDDDDDDDDDDDQQQQQQQQQQQQQQQQQ
WWWWWWWWWWWWQQQQQQQQQQQQQQQQQQQQQQQQQQDDDDDDDDDDDDDDDQQQQQQQQQQQQQQQQQ
WWWWWWWWWWWQQQQQQQQQQQQQQQQQQQQQQQQQQDDDDDDDDDDDDDDDQQQQQQQQQQQQQQQQQQ
WWWWWWWWWWQQQQQQQQQQQQQQQQQQQQQQQQQQDDDDDDDDDDDDDDDDQQQQQQQQQQQQQQQQQQ
WWWWWWWWWQQQQQQQQQQQQQQQQQQQQQQQQQQQDDDDDDDDDDDDDDDDQQQQQQQQQQQQQQQQQQ
WWWWWWWQQQQQQQQQQQQQQQQQQQQQQQQQQQQDDDDDDDDDDDDDDDDQQQQQQQQQQQQQQQQQQQ
WWWWWWQQQQQQQQQQQQQQQQQQQQQQQQQQQQDDDDDDDDDDDDDDDDDQQQQQQQQQQQQQQQQQQQ
WWWWQQQQQQQQQQQQQQQQQQQQQQQQQQQQQDDDDDDDDDDDDDDDDDQQQQQQQQQQQQQQQQQQQW
WWWQQQQQQQQQQQQQQQQQQQQQQQQQQQQDDDDDDDDDDDDDDDDDDDQQQQQQQQQQQQQQQQQQQW
WQQQQQQQQQQQQQQQQQQQQQQQQQQQQQDDDDDDDDDDDDDDDDDDDDQQQQQQQQQQQQQQQQQQQW
QQQQQQQQQQQQQQQQQQQQQQQQQQQQDDDDDDDDDDDDDDDDDDDDDQQQQQQQQQQQQQQQQQQQWW
QQQQQQQQQQQQQQQQQQQQQQQQQQDDDDDDDDDDDDDDDDDDDDDDDQQQQQQQQQQQQQQQQQQQWW
QQQQQQQQQQQQQQQQQQQQQQQQDDDDDDDDDDDDDDDDDDDDDDDDQQQQQQQQQQQQQQQQQQQQWW
QQQQQQQQQQQQQQQQQQQQQDDDDDDDDDDDDDDDDDDDDDDDDDDDQQQQQQQQQQQQQQQQQQQQWW
QQQQQQQQQQQQQQQQQQDDDDDDDDDDDDDDDDDDDDDDDDDDDDDQQQQQQQQQQQQQQQQQQQQWWW
QQQQQQQQQQQQQQQDDDDDDDDDDDDDDDDDDDDDDDDDDDDDDDDQQQQQQQQQQQQQQQQQQQQWWW
QQQQQQQQQQQQDDDDDDDDDDDDDDDDDDDDDDDDDDDDDDDDDDQQQQQQQQQQQQQQQQQQQQQWWW
QQQQQQQQQDDDDDDDDDDDDDDDDDDDDDDDDDDDDDDDDDDDDDQQQQQQQQQQQQQQQQQQQQQWWW
QQQQQQDDDDDDDDDDDDDDDDDDDDDDDDDDDDDDDDDDDDDDDQQQQQQQQQQQQQQQQQQQQQQWWW
QQQQDDDDDDDDDDDDDDDDDDDDDDDDDDDDDDDDDDDDDDDDQQQQQQQQQQQQQQQQQQQQQQQWWW
QDDDDDDDDDDDDDDDDDDDDDDDDDDDDDDDDDDDDDDDDDDQQQQQQQQQQQQQQQQQQQQQQQQWWW
DDDDDDDDDDDDDDDDDDDDDDDDDDDDDDDDDDDDDDDDDDDQQQQQQQQQQQQQQQQQQQQQQQQWWW
DDDDDDDDDDDDDDDDDDDDDDDDDDDDDDDDDDDDDDDDDDQQQQQQQQQQQQQQQQQQQQQQQQQWWW
DDDDDDDDDDDDDDDDDDDDDDDDDDDDDDDDDDDDDDDDDQQQQQQQQQQQQQQQQQQQQQQQQQQWWW
DDDDDDDDDDDDDDDDDDDDDDDDDDDDDDDDDDDDDDDDQQQQQQQQQQQQQQQQQQQQQQQQQQQWWW
DDDDDDDDDDDDDDDDDDDDDDDDDDDDDDDDDDDDDDQQQQQQQQQQQQQQQQQQQQQQQQQQQQQQWW
DDDDDDDDDDDDDDDDDDDDDDDDDDDDDDDDDDDDDQQQQQQQQQQQQQQQQQQQQQQQQQQQQQQQWW
DDDDDDDDDDDDDDDDDDDDDDDDDDDDDDDDDDDDQQQQQQQQQQQQQQQQQQQQQQQQQQQQQQQQWW
DDDDDDDDDDDDDDDDDDDDDDDDDDDDDDDDDDDQQQQQQQQQQQQQQQQQQQQQQQQQQQQQQQQQQW
DDDDDDDDDDDDDDDDDDDDDDDDDDDDDDDDDDQQQQQQQQQQQQQQQQQQQQQQQQQQQQQQQQQQQQ
DDDDDDDDDDDDDDDDDDDDDDDDDDDDDDDDDQQQQQQQQQQQQQQQQQQQQQQQQQQQQQQQQQQQQQ
---
......................................................................
......................................................................
......................................................................
......................................................................
......................................................................
......................................................................
......................................................................
......................................................................
......................................................................
......................................................................
......................................................................
......................................................................
......................................................................
......................................................................
......................................................................
......................................................................
......................................................................
......................................................................
......................................................................
......................................................................
......................................................................
......................................................................
......................................................................
......................................................................
......................................................................
......................................................................
......................................................................
......................................................................
......................................................................
......................................................................
......................................................................
......................................................................
......................................................................
......................................................................
........................................BB..............B.............
........................................B..............BB.............
........................................B..............B..............
........................................B.............B...............
......................................BB..............B...............
......................................B..............B................
......................................BBBBB..BBBBBBBB.................
......................................SSSSS..BBSSSSS..................
........................................SS...BSSBB....................
.......................................SS....SS.......................
......................................SS....SSS.......................
.....................................SS....SSS........................
...........................................SS.........................
......................................................................
......................................................................
......................................................................
......................................................................
......................................................................
......................................................................
......................................................................
......................................................................
......................................................................
......................................................................
......................................................................
......................................................................
......................................................................
......................................................................
......................................................................
......................................................................
......................................................................
......................................................................
......................................................................
......................................................................
......................................................................
......................................................................
......................................................................