XXXXXXXXXXXXXXXXXXXXXXXXXXXXXXXX
XXXXXXXXXXXXXXXXXXXXXXXXXXXXXXXX
XX..........XXXXXXXX..........XX
XX..........X......X..........XX
XX..XXXXXX..X......X..XXXXXX..XX
XX..X....X..X......X..X....X..XX
XX..X....X..X......X..X....X..XX
XX..X....X..X......X..X....X..XX
XX..X....X..X......X..X....X..XX
XX..X....X..X......X..X....X..XX
XX..X....X..X......X..X....X..XX
XX..X....X..X......X..X....X..XX
XX..X....X..X......X..X....X..XX
XX..X....X..X......X..X....X..XX
XX..X....X..X......X..X....X..XX
XX..X....X..X......X..X....X..XX
XX..X....X..X......X..X....X..XX
XX..X....X..X......X..X....X..XX
XX..X....X..X......X..X....X..XX
XX..X....X..X......X..X....X..XX
XX..XXXXXX..X......X..XXXXXX..XX
XX..........X......X..........XX
XX..........X......X..........XX
XX....1.....X......X..........XX
XXXXXXXXXXXXXXXXXXXXXXXXXXXXXXXX
XXXXXXXXXXXXXXXXXXXXXXXXXXXXXXXX