XXXXXXXXXXXXXXXXXXXXXXXXXXXXXXXX
XXXXXXXXXXXXXXXXXXXXXXXXXXXXXXXX
XX......XXXXXXXXXXXXXXXX......XX
XX......X..............X......XX
XX......X.XXXXXXXXXXXX.X......XX
XX......X.X..........X.X......XX
XX......X.X..........X.X......XX
XX......X.X..........X.X......XX
XX......X.X..........X.X......XX
XX......X.XXXXXXXXXXXX.X......XX
XX......X..............X......XX
XX......X..............X......XX
XX......X......1.......X......XX
XX......X..............X......XX
XX......X..............X......XX
XX......X.X..........X.X......XX
XX......X.X..........X.X......XX
XX......X.X..........X.X......XX
XX......X.X..........X.X......XX
XX......X.X..........X.X......XX
XX......X.X..........X.X......XX
XX......X..XXXXXXXXXX..X......XX
XX......X..............X......XX
XX......XXXXXXXXXXXXXXXX......XX
XXXXXXXXXXXXXXXXXXXXXXXXXXXXXXXX
XXXXXXXXXXXXXXXXXXXXXXXXXXXXXXXX
---
DDDDDDDDDDDDDDDDDDDDDDDDDDDDDDDD
DDDDDDDDDDDDDDDDDDDDDDDDDDDDDDDD
DD............................DD
DD............................DD
DD.DD.DDDDDDDDDDDDDD.DD .DDDD.DD
DD.DD.DD..........DD.DD.DDDD.DDD
DD.DD.DD..........DD.DD.DDDDDDDD
DD.DD.DD..........DD.DD.DDDDD.DD
DD.DD.DD..........DD.DD.DDDD.DDD
DD.DD.DD..........DD.DD.....D.DD
DD.DD.DD..........DD.DD.....D.DD
DD.DD..DDDDDDDDDD..DD.DD......DD
DD.DD..............DD.DD......DD
DD.DD.DDDDDDDDDDDD.DD.DD......DD
DD.DD.DD..........DD.DD....D..DD
DD.DD.DD..........DD.DD....D..DD
DD.DD.DD..........DD.DD....D..DD
DD.DD.DD..........DD.DD....D..DD
DD.DD.DD..........DD.DD.DD.D..DD
DD.DD.DD..........DD.DD....D..DD
DD.DD.DD..........DD.DD....D..DD
DD.DD..DDDDDDDDDD..DD.DD......DD
DD.DD..............DD.DD.....DDD
DD.DD.DDDDDDDDDDDD.DD.DD......DD
DDDDDDDDDDDDDDDDDDDDDDDDDDDDDDDD
DDDDDDDDDDDDDDDDDDDDDDDDDDDDDDDD
