XXXXXXXXXXXXXXXXXXXXXXXXXXXXXXXX
XXXXXXXXXXXXXXXXXXXXXXXXXXXXXXXX
XX......XXXXXXXXXXXXXXXX......XX
XX......X..............X......XX
XX......X.XXXXXXXXXXXX.X.DDDD.XX
XX......X.X..........X.X.DDDD.XX
XX......X.X..........X.X.DDDD.XX
XX......X.X..........X.X.DDDD.XX
XX......X.X..........X.X.DDDD.XX
XX......X.X..........X.X......XX
XX......X.X..........X.X......XX
XX......X..XXXXXXXXXX..X......XX
XX......X..............X......XX
XX......X.XXXXXXXXXXXX.X......XX
XX......X.X..........X.X......XX
XX......X.X..........X.X......XX
XX......X.X..........X.X......XX
XX......X.X..........X.X......XX
XX......X.X..........X.X...D..XX
XX......X.X..........X.X......XX
XX......X.X..........X.X......XX
XX......X..XXXXXXXXXX..X......XX
XX......X..............X...1..XX
XX......XXXXXXXXXXXXXXXX......XX
XXXXXXXXXXXXXXXXXXXXXXXXXXXXXXXX
XXXXXXXXXXXXXXXXXXXXXXXXXXXXXXXX
