XXXXXXXXXXXXXXXXXXXXXXXXXXXXXXXX
XXXXXXXXXXXXXXXXXXXXXXXXXXXXXXXX
XX............................XX
XX............................XX
XX............................XX
XX............................XX
XX............................XX
XX............................XX
XX............................XX
XX............................XX
XX............................XX
XX............................XX
XX............1...............XX
XX............................XX
XX............................XX
XX............................XX
XX............................XX
XX............................XX
XX............................XX
XX............................XX
XX............................XX
XX............................XX
XX............................XX
XX............................XX
XX............................XX
XXXXXXXXXXXXXXXXXXXXXXXXXXXXXXXX
XXXXXXXXXXXXXXXXXXXXXXXXXXXXXXXX
